繁體	简体	吳拼	備注
枝	枝	tsɿ⁵¹	樹枝
肢	肢	tsɿ⁵¹	
梔	栀	tsɿ⁵¹	
資	资	tsɿ⁵¹	
姿	姿	tsɿ⁵¹	
諮	咨	tsɿ⁵¹	
脂	脂	tsɿ⁵¹	
茲	兹	tsɿ⁵¹	
滋	滋	tsɿ⁵¹	
輜	辎	tsɿ⁵¹	
之	之	tsɿ⁵¹	
芝	芝	tsɿ⁵¹	
煮	煮	tsɿ³⁴	
鼠	鼠	tsɿ³⁴	又音
紫	紫	tsɿ³⁴	
紙	纸	tsɿ³⁴	
姊	姊	tsɿ³⁴	
旨	旨	tsɿ³⁴	
指	指	tsɿ³⁴	
子	子	tsɿ³⁴	
梓	梓	tsɿ³⁴	
滓	滓	tsɿ³⁴	
止	止	tsɿ³⁴	
趾	趾	tsɿ³⁴	
址	址	tsɿ³⁴	
齒	齿	tsɿ³⁴	又音
致	致	tsɿ⁴⁴	
至	至	tsɿ⁴⁴	
置	置	tsɿ⁴⁴	又音
志	志	tsɿ⁴⁴	
誌	誌	tsɿ⁴⁴	
痣	痣	tsɿ⁴⁴	文讀
雌	雌	tsʰɿ⁵¹	
疵	疵	tsʰɿ⁵¹	
差	差	tsʰɿ⁵¹	參差
嗤	嗤	tsʰɿ⁵¹	
此	此	tsʰɿ³⁴	
侈	侈	tsʰɿ³⁴	
齒	齿	tsʰɿ³⁴	
刺	刺	tsʰɿ⁴⁴	
賜	赐	tsʰɿ⁴⁴	
翅	翅	tsʰɿ⁴⁴	
次	次	tsʰɿ⁴⁴	
廁	厕	tsʰɿ⁴⁴	
池	池	dzɿ²²	文讀
馳	驰	dzɿ²²	
瓷	瓷	dzɿ²²	
慈	慈	dzɿ²²	
磁	磁	dzɿ²²	
辭	辞	dzɿ²²	
詞	词	dzɿ²²	
祠	祠	dzɿ²²	
持	持	dzɿ²²	
滯	滞	dzɿ¹³	
雉	雉	dzɿ¹³	
稚	稚	dzɿ¹³	
痔	痔	dzɿ¹³	
梳	梳	sɿ⁵¹	動詞，白讀
斯	斯	sɿ⁵¹	
廝	厮	sɿ⁵¹	
撕	撕	sɿ⁵¹	
篩	筛	sɿ⁵¹	動詞
施	施	sɿ⁵¹	
私	私	sɿ⁵¹	
師	师	sɿ⁵¹	
獅	狮	sɿ⁵¹	
屍	尸	sɿ⁵¹	
尸	尸	sɿ⁵¹	
司	司	sɿ⁵¹	
絲	丝	sɿ⁵¹	
思	思	sɿ⁵¹	
詩	诗	sɿ⁵¹	
篩	筛	sɿ³⁴	名詞
矢	矢	sɿ³⁴	
屎	屎	sɿ³⁴	
使	使	sɿ³⁴	
史	史	sɿ³⁴	
駛	驶	sɿ³⁴	
始	始	sɿ³⁴	
四	四	sɿ⁴⁴	
肆	肆	sɿ⁴⁴	
伺	伺	sɿ⁴⁴	
試	试	sɿ⁴⁴	
鋤	锄	zɿ²²	名詞
匙	匙	zɿ²²	鑰匙
是	是	zɿ²²	
氏	氏	zɿ²²	
豉	豉	zɿ²²	
時	时	zɿ²²	
鰣	鲥	zɿ²²	
誓	誓	zɿ¹³	
逝	逝	zɿ¹³	
自	自	zɿ¹³	文讀
示	示	zɿ¹³	
視	视	zɿ¹³	
嗜	嗜	zɿ¹³	
字	字	zɿ¹³	
似	似	zɿ¹³	
祀	祀	zɿ¹³	
巳	巳	zɿ¹³	
寺	寺	zɿ¹³	
嗣	嗣	zɿ¹³	
飼	饲	zɿ¹³	
士	士	zɿ¹³	
仕	仕	zɿ¹³	
柿	柿	zɿ¹³	
俟	俟	zɿ¹³	
事	事	zɿ¹³	
市	市	zɿ¹³	
恃	恃	zɿ¹³	
侍	侍	zɿ¹³	
諸	诸	tsʮ⁵¹	
誅	诛	tsʮ⁵¹	
蛛	蛛	tsʮ⁵¹	
株	株	tsʮ⁵¹	
朱	朱	tsʮ⁵¹	
硃	硃	tsʮ⁵¹	
珠	珠	tsʮ⁵¹	
知	知	tsʮ⁵¹	
蜘	蜘	tsʮ⁵¹	
支	支	tsʮ⁵¹	
枝	枝	tsʮ⁵¹	量詞
豬	猪	tsʮ³⁴	
拄	拄	tsʮ³⁴	拄柺杖
主	主	tsʮ³⁴	
嘴	嘴	tsʮ³⁴	
著	著	tsʮ⁴⁴	顯著
注	注	tsʮ⁴⁴	
蛀	蛀	tsʮ⁴⁴	
鑄	铸	tsʮ⁴⁴	
制	制	tsʮ⁴⁴	
製	製	tsʮ⁴⁴	
智	智	tsʮ⁴⁴	
置	置	tsʮ⁴⁴	
趨	趋	tsʰʮ⁵¹	
癡	痴	tsʰʮ⁵¹	
吹	吹	tsʰʮ⁵¹	白讀
褚	褚	tsʰʮ³⁴	姓
處	处	tsʰʮ³⁴	相處
杵	杵	tsʰʮ³⁴	
鼠	鼠	tsʰʮ³⁴	
取	取	tsʰʮ³⁴	
娶	娶	tsʰʮ³⁴	
恥	耻	tsʰʮ³⁴	
處	处	tsʰʮ⁴⁴	處所
趣	趣	tsʰʮ⁴⁴	
除	除	dzʮ²²	
鋤	锄	dzʮ²²	動詞
廚	厨	dzʮ²²	
治	治	dzʮ¹³	
柱	柱	dzʮ¹³	
住	住	dzʮ¹³	
書	书	sʮ⁵¹	
舒	舒	sʮ⁵¹	
須	须	sʮ⁵¹	
需	需	sʮ⁵¹	
樞	枢	sʮ⁵¹	
輸	输	sʮ⁵¹	輸贏
暑	暑	sʮ³⁴	
黍	黍	sʮ³⁴	
數	数	sʮ³⁴	動詞
水	水	sʮ³⁴	白讀
庶	庶	sʮ⁴⁴	
恕	恕	sʮ⁴⁴	
戍	戍	sʮ⁴⁴	
輸	输	sʮ⁴⁴	運輸
世	世	sʮ⁴⁴	
勢	势	sʮ⁴⁴	
歲	岁	sʮ⁴⁴	白讀
儲	储	zʮ²²	儲蓄
如	如	zʮ²²	
殊	殊	zʮ²²	
序	序	zʮ¹³	
敘	叙	zʮ¹³	
緒	绪	zʮ¹³	
苧	苎	zʮ¹³	苧麻
署	署	zʮ¹³	
薯	薯	zʮ¹³	
汝	汝	zʮ¹³	
聚	聚	zʮ¹³	
續	续	zʮ¹³	又音
豎	竖	zʮ¹³	
樹	树	zʮ¹³	
儒	儒	zʮ¹³	
乳	乳	zʮ¹³	
蓖	蓖	pi⁵¹	蓖麻
鞭	鞭	pi⁵¹	
編	编	pi⁵¹	
邊	边	pi⁵¹	
蝙	蝙	pi⁵¹	
遍	遍	pi⁵¹	量詞
彼	彼	pi³⁴	
鄙	鄙	pi³⁴	
比	比	pi³⁴	
貶	贬	pi³⁴	
扁	扁	pi³⁴	
匾	匾	pi³⁴	
蔽	蔽	pi⁴⁴	
閉	闭	pi⁴⁴	文讀
箅	箅	pi⁴⁴	
臂	臂	pi⁴⁴	
祕	秘	pi⁴⁴	
秘	秘	pi⁴⁴	
泌	泌	pi⁴⁴	
庇	庇	pi⁴⁴	
痹	痹	pi⁴⁴	
變	变	pi⁴⁴	
遍	遍	pi⁴⁴	
批	批	pʰi⁵¹	
披	披	pʰi⁵¹	
丕	丕	pʰi⁵¹	
篇	篇	pʰi⁵¹	
偏	偏	pʰi⁵¹	
譬	譬	pʰi⁴⁴	譬喻
屁	屁	pʰi⁴⁴	
騙	骗	pʰi⁴⁴	
片	片	pʰi⁴⁴	
皮	皮	bi²²	
疲	疲	bi²²	
脾	脾	bi²²	
琵	琵	bi²²	
枇	枇	bi²²	
肥	肥	bi²²	白讀
便	便	bi²²	便宜
敝	敝	bi¹³	
弊	弊	bi¹³	
幣	币	bi¹³	
斃	毙	bi¹³	
陛	陛	bi¹³	
鐾	鐾	bi¹³	鐾刀布，把刀鐾鐾
被	被	bi¹³	被臥，被子
婢	婢	bi¹³	
避	避	bi¹³	
篦	篦	bi¹³	
辨	辨	bi¹³	
辯	辩	bi¹³	
汴	汴	bi¹³	
便	便	bi¹³	方便
辮	辫	bi¹³	
閉	闭	ʔmi⁴⁴	白讀
迷	迷	mi²²	
謎	谜	mi²²	
彌	弥	mi²²	
綿	绵	mi²²	
棉	棉	mi²²	
眠	眠	mi²²	
米	米	mi¹³	
靡	靡	mi¹³	
眉	眉	mi¹³	白讀
未	未	mi¹³	白讀
味	味	mi¹³	白讀
免	免	mi¹³	
勉	勉	mi¹³	
娩	娩	mi¹³	
緬	缅	mi¹³	
澠	渑	mi¹³	
面	面	mi¹³	
麪	面	mi¹³	
麵	面	mi¹³	
非	非	fi⁵¹	
飛	飞	fi⁵¹	
妃	妃	fi⁵¹	
匪	匪	fi³⁴	
榧	榧	fi³⁴	
廢	废	fi⁴⁴	
肺	肺	fi⁴⁴	
吠	吠	fi⁴⁴	
痱	痱	fi⁴⁴	
費	费	fi⁴⁴	
翡	翡	fi⁴⁴	
維	维	vi²²	
惟	惟	vi²²	
唯	唯	vi²²	
肥	肥	vi²²	文讀
微	微	vi²²	
尾	尾	vi¹³	文讀
未	未	vi¹³	文讀
味	味	vi¹³	文讀
低	低	ti⁵¹	
堤	堤	ti⁵¹	
掂	掂	ti⁵¹	
顛	颠	ti⁵¹	
底	底	ti³⁴	
抵	抵	ti³⁴	
點	点	ti³⁴	
㸃	点	ti³⁴	
典	典	ti³⁴	
帝	帝	ti⁴⁴	
店	店	ti⁴⁴	
梯	梯	tʰi⁵¹	文讀
添	添	tʰi⁵¹	
天	天	tʰi⁵¹	
體	体	tʰi³⁴	
舔	舔	tʰi³⁴	
腆	腆	tʰi³⁴	
替	替	tʰi⁴⁴	
涕	涕	tʰi⁴⁴	
剃	剃	tʰi⁴⁴	
屜	屉	tʰi⁴⁴	
屉	屉	tʰi⁴⁴	
掭	掭	tʰi⁴⁴	
題	题	di²²	
提	提	di²²	
蹄	蹄	di²²	
啼	啼	di²²	
甜	甜	di²²	
田	田	di²²	
填	填	di²²	
塡	填	di²²	
弟	弟	di¹³	
第	第	di¹³	
遞	递	di¹³	
隸	隶	di¹³	奴隸，又音
地	地	di¹³	
電	电	di¹³	
殿	殿	di¹³	
奠	奠	di¹³	
佃	佃	di¹³	
墊	垫	di¹³	
驢	驴	li²²	
犁	犁	li²²	
黎	黎	li²²	
籬	篱	li²²	
璃	璃	li²²	
梨	梨	li²²	
釐	厘	li²²	
狸	狸	li²²	
廉	廉	li²²	
鐮	镰	li²²	
簾	帘	li²²	
連	连	li²²	
聯	联	li²²	
憐	怜	li²²	
蓮	莲	li²²	
呂	吕	li¹³	
旅	旅	li¹³	
慮	虑	li¹³	
濾	滤	li¹³	
縷	缕	li¹³	
屢	屡	li¹³	又音
例	例	li¹³	
厲	厉	li¹³	
勵	励	li¹³	
禮	礼	li¹³	
麗	丽	li¹³	美麗
隸	隶	li¹³	
荔	荔	li¹³	
離	离	li¹³	
履	履	li¹³	
利	利	li¹³	
痢	痢	li¹³	
李	李	li¹³	
里	里	li¹³	
裏	裏	li¹³	
裡	裏	li¹³	
理	理	li¹³	
鯉	鲤	li¹³	
吏	吏	li¹³	
淚	泪	li¹³	
斂	敛	li¹³	
殮	殓	li¹³	
練	练	li¹³	
煉	炼	li¹³	
楝	楝	li¹³	楝樹
戀	恋	li¹³	
稽	稽	tɕi⁵¹	
飢	饥	tɕi⁵¹	
肌	肌	tɕi⁵¹	
基	基	tɕi⁵¹	
幾	几	tɕi⁵¹	幾乎
機	机	tɕi⁵¹	
譏	讥	tɕi⁵¹	
饑	饥	tɕi⁵¹	
尖	尖	tɕi⁵¹	
殲	歼	tɕi⁵¹	
沾	沾	tɕi⁵¹	
瞻	瞻	tɕi⁵¹	
兼	兼	tɕi⁵¹	
搛	搛	tɕi⁵¹	搛菜
艱	艰	tɕi⁵¹	
間	间	tɕi⁵¹	空間，中間，間斷
煎	煎	tɕi⁵¹	
氈	毡	tɕi⁵¹	
箋	笺	tɕi⁵¹	
肩	肩	tɕi⁵¹	
堅	坚	tɕi⁵¹	
擠	挤	tɕi³⁴	
雞	鸡	tɕi³⁴	
鷄	鸡	tɕi¹³	
几	几	tɕi³⁴	茶几
己	己	tɕi³⁴	
幾	几	tɕi³⁴	幾個
檢	检	tɕi³⁴	
簡	简	tɕi³⁴	
柬	柬	tɕi³⁴	
剪	剪	tɕi³⁴	
展	展	tɕi³⁴	
祭	祭	tɕi⁴⁴	
際	际	tɕi⁴⁴	
濟	济	tɕi⁴⁴	
劑	剂	tɕi⁴⁴	
計	计	tɕi⁴⁴	
繼	继	tɕi⁴⁴	
繫	系	tɕi⁴⁴	繫鞋帶
髻	髻	tɕi⁴⁴	
寄	寄	tɕi⁴⁴	
冀	冀	tɕi⁴⁴	
痣	痣	tɕi⁴⁴	白讀
紀	纪	tɕi⁴⁴	
記	记	tɕi⁴⁴	
既	既	tɕi⁴⁴	
季	季	tɕi⁴⁴	
鑑	鉴	tɕi⁴⁴	
鍳	鉴	tɕi⁴⁴	
佔	占	tɕi⁴⁴	
占	占	tɕi⁴⁴	
劍	剑	tɕi⁴⁴	
諫	谏	tɕi⁴⁴	
澗	涧	tɕi⁴⁴	
箭	箭	tɕi⁴⁴	
濺	溅	tɕi⁴⁴	
建	建	tɕi⁴⁴	
薦	荐	tɕi⁴⁴	
繭	茧	tɕi⁴⁴	
趼	趼	tɕi⁴⁴	
見	见	tɕi⁴⁴	
鯽	鲫	tɕi⁴⁴	又音
妻	妻	tɕʰi⁵¹	
棲	栖	tɕʰi⁵¹	
溪	溪	tɕʰi⁵¹	
欺	欺	tɕʰi⁵¹	
籤	签	tɕʰi⁵¹	
簽	签	tɕʰi⁵¹	
謙	谦	tɕʰi⁵¹	
遷	迁	tɕʰi⁵¹	
千	千	tɕʰi⁵¹	
牽	牵	tɕʰi⁵¹	
啓	启	tɕʰi³⁴	
啟	启	tɕʰi³⁴	
企	企	tɕʰi³⁴	
起	起	tɕʰi³⁴	
杞	杞	tɕʰi³⁴	
豈	岂	tɕʰi³⁴	
淺	浅	tɕʰi³⁴	
遣	遣	tɕʰi³⁴	
去	去	tɕʰi⁴⁴	
砌	砌	tɕʰi⁴⁴	
契	契	tɕʰi⁴⁴	
碶	碶	tɕʰi⁴⁴	
器	器	tɕʰi⁴⁴	
棄	弃	tɕʰi⁴⁴	
氣	气	tɕʰi⁴⁴	
汽	汽	tɕʰi⁴⁴	
欠	欠	tɕʰi⁴⁴	
歉	歉	tɕʰi⁴⁴	
其	其	dʑi²²	他
齊	齐	dʑi²²	文讀，如：齊國、姓
臍	脐	dʑi²²	
池	池	dʑi²²	白讀
奇	奇	dʑi²²	
騎	骑	dʑi²²	
歧	歧	dʑi²²	
遲	迟	dʑi²²	
祁	祁	dʑi²²	
鰭	鳍	dʑi²²	
其	其	dʑi²²	
棋	棋	dʑi²²	
期	期	dʑi²²	
旗	旗	dʑi²²	
祈	祈	dʑi²²	
潛	潜	dʑi²²	
鉗	钳	dʑi²²	
錢	钱	dʑi²²	
纏	缠	dʑi²²	
乾	乾	dʑi²²	乾坤
虔	虔	dʑi²²	
犍	犍	dʑi²²	
箸	箸	dʑi¹³	筷箸籠：存放筷子的器具
薺	荠	dʑi¹³	
技	技	dʑi¹³	
妓	妓	dʑi¹³	
忌	忌	dʑi¹³	
漸	渐	dʑi¹³	
儉	俭	dʑi¹³	
踐	践	dʑi¹³	
餞	饯	dʑi¹³	
件	件	dʑi¹³	
鍵	键	dʑi¹³	
健	健	dʑi¹³	
腱	腱	dʑi¹³	
圈	圈	dʑi¹³	豬圈間：豬圈
黏	黏	ʔȵi⁴⁴	
粘	粘	ʔȵi⁴⁴	
拈	拈	ʔȵi⁴⁴	
泥	泥	ȵi²²	
倪	倪	ȵi²²	
宜	宜	ȵi²²	
儀	仪	ȵi²²	
尼	尼	ȵi²²	
疑	疑	ȵi²²	
沂	沂	ȵi²²	
閻	阎	ȵi²²	
嚴	严	ȵi²²	
年	年	ȵi²²	
研	研	ȵi²²	
藝	艺	ȵi¹³	
蟻	蚁	ȵi¹³	
誼	谊	ȵi¹³	
義	义	ȵi¹³	
議	议	ȵi¹³	
二	二	ȵi¹³	
貳	贰	ȵi¹³	
膩	腻	ȵi¹³	
耳	耳	ȵi¹³	白讀，又音
你	你	ȵi¹³	文讀
擬	拟	ȵi¹³	
毅	毅	ȵi¹³	
尾	尾	ȵi¹³	白讀
染	染	ȵi¹³	
驗	验	ȵi¹³	
儼	俨	ȵi¹³	
釅	酽	ȵi¹³	釅茶
念	念	ȵi¹³	又音，舊
碾	碾	ȵi¹³	
輦	辇	ȵi¹³	
撚	撚	ȵi¹³	
攆	撵	ȵi¹³	
硯	砚	ȵi¹³	
西	西	ɕi⁵¹	
犀	犀	ɕi⁵¹	
奚	奚	ɕi⁵¹	
兮	兮	ɕi⁵¹	
犧	牺	ɕi⁵¹	
嬉	嬉	ɕi⁵¹	
熙	熙	ɕi⁵¹	
希	希	ɕi⁵¹	
稀	稀	ɕi⁵¹	
仙	仙	ɕi⁵¹	
鮮	鲜	ɕi⁵¹	
軒	轩	ɕi⁵¹	
掀	掀	ɕi⁵¹	
先	先	ɕi⁵¹	
洗	洗	ɕi³⁴	
璽	玺	ɕi³⁴	
徙	徙	ɕi³⁴	
死	死	ɕi³⁴	
喜	喜	ɕi³⁴	
閃	闪	ɕi³⁴	
險	险	ɕi³⁴	
癬	癣	ɕi³⁴	
顯	显	ɕi³⁴	
細	细	ɕi⁴⁴	
婿	婿	ɕi⁴⁴	
系	系	ɕi⁴⁴	
戲	戏	ɕi⁴⁴	
線	线	ɕi⁴⁴	
綫	线	ɕi⁴⁴	
羶	膻	ɕi⁴⁴	
扇	扇	ɕi⁴⁴	
搧	扇	ɕi⁴⁴	
憲	宪	ɕi⁴⁴	
獻	献	ɕi⁴⁴	
徐	徐	ʑi²²	
齊	齐	ʑi²²	白讀
前	前	ʑi²²	
係	系	ʑi¹³	嘸納關係：不要緊，沒關係
自	自	ʑi¹³	白讀
賤	贱	ʑi¹³	
鋸	锯	ki⁵¹	白讀
甘	甘	ki⁵¹	
柑	柑	ki⁵¹	
泔	泔	ki⁵¹	泔水
干	干	ki⁵¹	
乾	干	ki⁵¹	
幹	干	ki⁵¹	
肝	肝	ki⁵¹	
狗	狗	ki³⁴	黃狗，兒化音
感	感	ki³⁴	
敢	敢	ki³⁴	
竿	竿	ki³⁴	
杆	杆	ki³⁴	
稈	稈	ki³⁴	
趕	赶	ki³⁴	
侅	侅	kʰi⁵¹	很多
看	看	kʰi⁴⁴	
移	移	ɦi²²	
夷	夷	ɦi²²	
姨	姨	ɦi²²	
飴	饴	ɦi²²	
遺	遗	ɦi²²	
炎	炎	ɦi²²	
鹽	盐	ɦi²²	
檐	檐	ɦi²²	
涎	涎	ɦi²²	
焉	焉	ɦi²²	心不在焉
延	延	ɦi²²	
筵	筵	ɦi²²	
言	言	ɦi²²	
賢	贤	ɦi²²	
弦	弦	ɦi²²	
沿	沿	ɦi²²	
鉛	铅	ɦi²²	鉛山，江西地名
易	易	ɦi¹³	
肄	肄	ɦi¹³	肄業
矣	矣	ɦi¹³	
已	已	ɦi¹³	
以	以	ɦi¹³	又音
異	异	ɦi¹³	
豔	艳	ɦi¹³	
艷	艳	ɦi¹³	
焰	焰	ɦi¹³	
鹽	盐	ɦi¹³	醃
諺	谚	ɦi¹³	
演	演	ɦi¹³	
現	现	ɦi¹³	
兗	兖	ɦi¹³	
伊	伊	i⁵¹	
醫	医	i⁵¹	
衣	衣	i⁵¹	
依	依	i⁵¹	
淹	淹	i⁵¹	
閹	阉	i⁵¹	
醃	腌	i⁵¹	
嫌	嫌	i⁵¹	
蔫	蔫	i⁵¹	食物不新鮮
煙	烟	i⁵¹	
菸	烟	i⁵¹	
憶	忆	i⁵¹	
億	亿	i⁵¹	
倚	倚	i³⁴	
以	以	i³⁴	
掩	掩	i³⁴	
意	意	i⁴⁴	
厭	厌	i⁴⁴	
豔	艳	i⁴⁴	又音
艷	艳	i⁴⁴	又音
雁	雁	i⁴⁴	文讀
堰	堰	i⁴⁴	
燕	燕	i⁴⁴	
咽	咽	i⁴⁴	
嚥	咽	i⁴⁴	
宴	宴	i⁴⁴	
補	补	pu³⁴	
布	布	pu⁴⁴	
佈	佈	pu⁴⁴	
怖	怖	pu⁴⁴	
鋪	铺	pʰu⁵¹	鋪設
譜	谱	pʰu³⁴	
普	普	pʰu³⁴	
浦	浦	pʰu³⁴	
鋪	铺	pʰu⁴⁴	店鋪
蒲	蒲	bu²²	
菩	菩	bu²²	
脯	脯	bu²²	胸脯
脯	脯	bu²²	杏脯
孵	孵	bu²²	孵小雞
部	部	bu¹³	
簿	簿	bu¹³	
步	步	bu¹³	
捕	捕	bu¹³	
埠	埠	bu¹³	
呼	呼	fu⁵¹	
夫	夫	fu⁵¹	
膚	肤	fu⁵¹	
敷	敷	fu⁵¹	
俘	俘	fu⁵¹	
麩	麸	fu⁵¹	
虎	虎	fu³⁴	
滸	浒	fu³⁴	水滸
府	府	fu³⁴	
腑	腑	fu³⁴	
甫	甫	fu³⁴	
斧	斧	fu³⁴	
殕	殕	fu³⁴	食上生白毛，如：白殕冬瓜
釜	釜	fu³⁴	
輔	辅	fu³⁴	又音
戽	戽	fu⁴⁴	戽水
付	付	fu⁴⁴	
賦	赋	fu⁴⁴	
傅	傅	fu⁴⁴	
赴	赴	fu⁴⁴	
訃	讣	fu⁴⁴	
富	富	fu⁴⁴	
副	副	fu⁴⁴	
阜	阜	fu⁴⁴	
吳	吴	vu²²	文讀
蜈	蜈	vu²²	蜈蚣，文讀
吾	吾	vu²²	
梧	梧	vu²²	梧桐
胡	胡	vu²²	
湖	湖	vu²²	
狐	狐	vu²²	
壺	壶	vu²²	
乎	乎	vu²²	
葫	葫	vu²²	葫蘆
符	符	vu²²	
扶	扶	vu²²	
芙	芙	vu²²	
浮	浮	vu²²	
伍	伍	vu¹³	文讀
午	午	vu¹³	
悟	悟	vu¹³	文讀
戶	户	vu¹³	
戸	户	vu¹³	
户	户	vu¹³	
滬	沪	vu¹³	
互	互	vu¹³	
護	护	vu¹³	
惡	恶	vu¹³	可惡
撫	抚	vu¹³	
父	父	vu¹³	
腐	腐	vu¹³	
輔	辅	vu¹³	
附	附	vu¹³	
無	无	vu¹³	
武	武	vu¹³	
舞	舞	vu¹³	
侮	侮	vu¹³	
鵡	鹉	vu¹³	鸚鵡
務	务	vu¹³	
霧	雾	vu¹³	
婦	妇	vu¹³	
都	都	tu⁵¹	
堵	堵	tu³⁴	
賭	赌	tu³⁴	
肚	肚	tu³⁴	豬肚
妒	妒	tu⁴⁴	
土	土	tʰu³⁴	
吐	吐	tʰu³⁴	吐痰
吐	吐	tʰu⁴⁴	嘔吐
兔	兔	tʰu⁴⁴	
徒	徒	du²²	
屠	屠	du²²	
途	途	du²²	
塗	涂	du²²	
涂	涂	du²²	
圖	图	du²²	
杜	杜	du¹³	
肚	肚	du¹³	腹肚
度	度	du¹³	
渡	渡	du¹³	
鍍	镀	du¹³	
盧	卢	lu²²	
爐	炉	lu²²	
蘆	芦	lu²²	蘆葦
鸕	鸕	lu²²	鸕鶿
廬	庐	lu²²	茅廬，廬山
魯	鲁	lu¹³	
櫓	橹	lu¹³	
滷	卤	lu¹³	
鹵	卤	lu¹³	
路	路	lu¹³	
露	露	lu¹³	
鷺	鹭	lu¹³	鷺鷥
租	租	tsu⁵¹	
祖	祖	tsu³⁴	
組	组	tsu³⁴	
阻	阻	tsu³⁴	
粗	粗	tsʰu⁵¹	
初	初	tsʰu⁵¹	
楚	楚	tsʰu³⁴	
礎	础	tsʰu³⁴	
醋	醋	tsʰu⁴⁴	
措	措	tsʰu⁴⁴	措置
雛	雏	dzu²²	
助	助	dzu¹³	
奴	奴	nu²²	
娛	娱	nu²²	
努	努	nu¹³	
怒	怒	nu¹³	
誤	误	nu¹³	
悟	悟	nu¹³	白讀
蘇	苏	su⁵¹	
酥	酥	su⁵¹	
梳	梳	su⁵¹	動詞，文讀
疏	疏	su⁵¹	疏遠
蔬	蔬	su⁵¹	
鬚	鬚	su⁵¹	
素	素	su⁴⁴	
訴	诉	su⁴⁴	
塑	塑	su⁴⁴	
疏	疏	su⁴⁴	註疏
數	数	su⁴⁴	名次
姑	姑	ku⁵¹	
孤	孤	ku⁵¹	
箍	箍	ku⁵¹	文讀，又音
古	古	ku³⁴	
估	估	ku³⁴	估計
牯	牯	ku³⁴	
股	股	ku³⁴	
鼓	鼓	ku³⁴	
故	故	ku⁴⁴	
固	固	ku⁴⁴	
錮	锢	ku⁴⁴	
僱	雇	ku⁴⁴	
顧	顾	ku⁴⁴	
箍	箍	kʰu⁵¹	文讀
枯	枯	kʰu⁵¹	
苦	苦	kʰu³⁴	
庫	库	kʰu⁴⁴	
褲	裤	kʰu⁴⁴	
跍	跍	ɡu²²	蹲
咕	咕	ɡu¹³	嘮叨、責備
烏	乌	u⁵¹	
污	污	u⁵¹	
巫	巫	u⁵¹	
誣	诬	u⁵¹	
塢	坞	u⁴⁴	
焐	焐	u⁴⁴	
居	居	tɕy⁵¹	
車	车	tɕy⁵¹	車馬炮
鋸	锯	tɕy⁵¹	文讀
拘	拘	tɕy⁵¹	
駒	驹	tɕy⁵¹	
句	句	tɕy⁵¹	
龜	龟	tɕy⁵¹	白讀
捐	捐	tɕy⁵¹	
矩	矩	tɕy³⁴	規矩
鬼	鬼	tɕy³⁴	白讀
卷	卷	tɕy³⁴	
據	据	tɕy⁴⁴	
貴	贵	tɕy⁴⁴	白讀
眷	眷	tɕy⁴⁴	
絹	绢	tɕy⁴⁴	
蛆	蛆	tɕʰy⁵¹	
區	区	tɕʰy⁵¹	區域
驅	驱	tɕʰy⁵¹	
圈	圈	tɕʰy⁵¹	圓圈
犬	犬	tɕʰy³⁴	
勸	劝	tɕʰy⁴⁴	
券	券	tɕʰy⁴⁴	
渠	渠	dʑy²²	
俱	俱	dʑy²²	
瞿	瞿	dʑy²²	
拳	拳	dʑy²²	
權	权	dʑy²²	
顴	颧	dʑy²²	
巨	巨	dʑy¹³	
拒	拒	dʑy¹³	
距	距	dʑy¹³	
具	具	dʑy¹³	
懼	惧	dʑy¹³	
跪	跪	dʑy¹³	白讀
櫃	柜	dʑy¹³	白讀
倦	倦	dʑy¹³	
愚	愚	ȵy²²	
虞	虞	ȵy²²	
娛	娱	ȵy²²	又音
緣	缘	ȵy²²	又音
元	元	ȵy²²	
原	原	ȵy²²	
源	源	ȵy²²	
女	女	ȵy¹³	
語	语	ȵy¹³	
遇	遇	ȵy¹³	
寓	寓	ȵy¹³	
蕊	蕊	ȵy¹³	白讀
軟	软	ȵy¹³	
阮	阮	ȵy¹³	
願	愿	ȵy¹³	
愿	愿	ȵy¹³	
靴	靴	ɕy⁵¹	
墟	墟	ɕy⁵¹	
虛	虚	ɕy⁵¹	
噓	嘘	ɕy⁵¹	
吁	吁	ɕy⁵¹	
喧	喧	ɕy⁵¹	
諠	喧	ɕy⁵¹	
許	许	ɕy³⁴	文讀
絮	絮	ɕy⁴⁴	
楦	楦	ɕy⁴⁴	鞋楦
漁	渔	ɦy²²	
於	於	ɦy²²	
餘	余	ɦy²²	
餘	馀	ɦy²²	
于	于	ɦy²²	
盂	盂	ɦy²²	
榆	榆	ɦy²²	
逾	逾	ɦy²²	
愉	愉	ɦy²²	
圓	圆	ɦy²²	
員	员	ɦy²²	
緣	缘	ɦy²²	
袁	袁	ɦy²²	
轅	辕	ɦy²²	
園	园	ɦy²²	
援	援	ɦy²²	
御	御	ɦy¹³	
禦	禦	ɦy¹³	
與	与	ɦy¹³	
譽	誉	ɦy¹³	
預	预	ɦy¹³	
豫	豫	ɦy¹³	
雨	雨	ɦy¹³	
宇	宇	ɦy¹³	
禹	禹	ɦy¹³	
羽	羽	ɦy¹³	
芋	芋	ɦy¹³	
愈	愈	ɦy¹³	
喻	喻	ɦy¹³	
裕	裕	ɦy¹³	
院	院	ɦy¹³	
遠	远	ɦy¹³	
玄	玄	ɦy¹³	
懸	悬	ɦy¹³	
縣	县	ɦy¹³	
眩	眩	ɦy¹³	
淤	淤	y⁵¹	
迂	迂	y⁵¹	
冤	冤	y⁵¹	
淵	渊	y⁵¹	
椅	椅	y³⁴	
喂	喂	y⁴⁴	白讀
怨	怨	y⁴⁴	
叭	叭	pa⁵¹	喇叭
擺	摆	pa³⁴	
拜	拜	pa⁴⁴	
派	派	pʰa⁴⁴	
排	排	ba²²	
簰	簰	ba²²	筏
牌	牌	ba¹³	
罷	罢	ba¹³	
敗	败	ba¹³	
☐	☐	ʔma⁵¹	☐記☐記：行動遲緩的樣子
買	买	ma¹³	
賣	卖	ma¹³	
戴	戴	ta⁴⁴	戴帽子
帶	带	ta⁴⁴	
拖	拖	tʰa⁵¹	流（鼻涕）；涕拖：髒
☐	☐	tʰa⁵¹	伸（舌頭）
☐	☐	tʰa⁵¹	拿，貶義
他	他	tʰa⁴⁴	
太	太	tʰa⁴⁴	
泰	泰	tʰa⁴⁴	
大	大	da¹³	文讀
大	大	da¹³	大夫；大黃，藥名
埭	埭	da¹³	量詞，（一）排、（一）趟
拉	拉	ʔla⁴⁴	
賴	赖	la¹³	
癩	癞	la¹³	
攋	攋	la¹³	
老	老	la¹³	又音，如：老太婆
抓	抓	tsa⁵¹	文讀
債	债	tsa⁴⁴	
釵	钗	tsʰa⁵¹	
差	差	tsʰa⁵¹	出差
蔡	蔡	tsʰa⁴⁴	
寨	寨	dza¹³	
咋	咋	dza¹³	
哪	哪	ʔna³⁴	
淖	淖	na²²	淖泥：泥土
嬲	嬲	na²²	嬲話：玩
那	那	na¹³	
奶	奶	na¹³	
灑	洒	sa³⁴	
傻	傻	sa³⁴	
耍	耍	sa³⁴	
曬	晒	sa⁴⁴	
豺	豺	za²²	
柴	柴	za²²	
篩	筛	za¹³	一種竹篾容器
階	阶	ka⁵¹	白讀
街	街	ka⁵¹	
解	解	ka³⁴	
介	介	ka⁴⁴	
界	界	ka⁴⁴	
芥	芥	ka⁴⁴	
尬	尬	ka⁴⁴	尷尬
疥	疥	ka⁴⁴	
屆	届	ka⁴⁴	
戒	戒	ka⁴⁴	
隘	隘	ka⁴⁴	
揩	揩	kʰa⁵¹	
楷	楷	kʰa³⁴	
懈	懈	ɡa¹³	懈悶：不感興趣
外	外	ŋa¹³	
捱	捱	ŋa¹³	拖延
雁	雁	ŋa¹³	白讀；雁鵝：大雁
哈	哈	ha⁵¹	哈腰
蟹	蟹	ha³⁴	
鞋	鞋	ɦa²²	
也	也	ɦa¹³	
挨	挨	a⁵¹	挨住
矮	矮	a³⁴	
靉	叆	a⁴⁴	濃雲蔽日，指天變多雲、陰天
嗲	嗲	tia³⁴	
家	家	tɕia⁵¹	文讀
嘉	嘉	tɕia⁵¹	文讀
傢	傢	tɕia⁵¹	傢具
佳	佳	tɕia⁵¹	
賈	贾	tɕia³⁴	姓
姐	姐	tɕia³⁴	
借	借	tɕia⁴⁴	
笡	笡	tɕʰia⁵¹	斜
茄	茄	dʑia²²	又音，舊；如：爛茄糊
寫	写	ɕia³⁴	
瀉	泻	ɕia⁴⁴	
卸	卸	ɕia⁴⁴	
邪	邪	ʑia²²	
斜	斜	ʑia²²	
謝	谢	ʑia¹³	
耶	耶	ɦia²²	
爺	爷	ɦia²²	
涯	涯	ɦia²²	
崖	崖	ɦia²²	
鞋	鞋	ɦia²²	
雅	雅	ɦia¹³	又音
霞	霞	ɦia¹³	文讀
瑕	瑕	ɦia¹³	
遐	遐	ɦia¹³	
也	也	ɦia¹³	
野	野	ɦia¹³	
夜	夜	ɦia¹³	
鴉	鸦	ia⁵¹	文讀
雅	雅	ia³⁴	
亞	亚	ia⁴⁴	
乖	乖	kua⁵¹	
寡	寡	kua³⁴	文讀
剮	剐	kua³⁴	文讀
柺	柺	kua³⁴	
拐	拐	kua³⁴	
怪	怪	kua⁴⁴	
蒯	蒯	kʰua⁵¹	
垮	垮	kʰua³⁴	
快	快	kʰua⁴⁴	
歪	歪	hua⁵¹	
懷	怀	ɦua²²	文讀
槐	槐	ɦua²²	
淮	淮	ɦua²²	
壞	坏	ɦua¹³	文讀
壞	坏	ua⁵¹	白讀
哇	哇	ua⁴⁴	
褒	褒	pɔ⁵¹	
包	包	pɔ⁵¹	
胞	胞	pɔ⁵¹	
保	保	pɔ³⁴	
堡	堡	pɔ³⁴	
寶	宝	pɔ³⁴	
飽	饱	pɔ³⁴	
報	报	pɔ⁴⁴	
豹	豹	pɔ⁴⁴	
拋	抛	pʰɔ⁵¹	
炮	炮	pʰɔ⁴⁴	
泡	泡	pʰɔ⁴⁴	
袍	袍	bɔ²²	
跑	跑	bɔ²²	
刨	刨	bɔ²²	動詞
麅	麅	bɔ²²	
抱	抱	bɔ¹³	
暴	暴	bɔ¹³	
爆	爆	bɔ¹³	
刨	刨	bɔ¹³	名詞
鮑	鲍	bɔ¹³	
毛	毛	mɔ²²	
茅	茅	mɔ²²	
錨	锚	mɔ²²	
矛	矛	mɔ²²	又音
冒	冒	mɔ¹³	
帽	帽	mɔ¹³	
貓	猫	mɔ¹³	
卯	卯	mɔ¹³	
貌	貌	mɔ¹³	
茂	茂	mɔ¹³	又音
貿	贸	mɔ¹³	又音
刀	刀	tɔ⁵¹	
叨	叨	tɔ⁵¹	
禱	祷	tɔ³⁴	
島	岛	tɔ³⁴	
倒	倒	tɔ³⁴	打倒，顛倒
到	到	tɔ⁴⁴	
倒	倒	tɔ⁴⁴	倒水
滔	滔	tʰɔ⁵¹	
掏	掏	tʰɔ⁵¹	
討	讨	tʰɔ³⁴	
套	套	tʰɔ⁴⁴	
桃	桃	dɔ²²	
逃	逃	dɔ²²	
淘	淘	dɔ²²	
陶	陶	dɔ²²	
萄	萄	dɔ²²	
濤	涛	dɔ²²	
道	道	dɔ¹³	
稻	稻	dɔ¹³	
盜	盗	dɔ¹³	
導	导	dɔ¹³	
撈	捞	ʔlɔ⁵¹	
嘮	唠	ʔlɔ⁴⁴	嘮叨
勞	劳	lɔ²²	
牢	牢	lɔ²²	
老	老	lɔ¹³	
澇	涝	lɔ¹³	
遭	遭	tsɔ⁵¹	
糟	糟	tsɔ⁵¹	
抓	抓	tsɔ⁵¹	白讀
早	早	tsɔ³⁴	
蚤	蚤	tsɔ³⁴	
澡	澡	tsɔ³⁴	
爪	爪	tsɔ³⁴	
找	找	tsɔ³⁴	
躁	躁	tsɔ⁴⁴	
竈	灶	tsɔ⁴⁴	
罩	罩	tsɔ⁴⁴	
笊	笊	tsɔ⁴⁴	
操	操	tsʰɔ⁵¹	
抄	抄	tsʰɔ⁵¹	
鈔	钞	tsʰɔ⁵¹	
草	草	tsʰɔ³⁴	
炒	炒	tsʰɔ³⁴	
吵	吵	tsʰɔ³⁴	
糙	糙	tsʰɔ⁴⁴	
曹	曹	dzɔ²²	
槽	槽	dzɔ²²	
巢	巢	dzɔ²²	
皁	皂	dzɔ¹³	
皂	皂	dzɔ¹³	
造	造	dzɔ¹³	造反
鐃	铙	nɔ²²	
撓	挠	nɔ²²	
腦	脑	nɔ¹³	
惱	恼	nɔ¹³	
鬧	闹	nɔ¹³	
騷	骚	sɔ⁵¹	
臊	臊	sɔ⁵¹	
梢	梢	sɔ⁵¹	
捎	捎	sɔ⁵¹	
掃	扫	sɔ³⁴	掃地
嫂	嫂	sɔ³⁴	
掃	扫	sɔ⁴⁴	掃帚
稍	稍	sɔ⁴⁴	
潲	潲	sɔ⁴⁴	
少	少	sɔ⁴⁴	少年，新讀音
皁	皂	zɔ¹³	又音
皂	皂	zɔ¹³	又音
造	造	zɔ¹³	建造
高	高	kɔ⁵¹	
膏	膏	kɔ⁵¹	
篙	篙	kɔ⁵¹	
羔	羔	kɔ⁵¹	
糕	糕	kɔ⁵¹	
交	交	kɔ⁵¹	白讀
膠	胶	kɔ⁵¹	
教	教	kɔ⁵¹	教書
稿	稿	kɔ³⁴	
絞	绞	kɔ³⁴	
鉸	铰	kɔ³⁴	
攪	搅	kɔ³⁴	
告	告	kɔ⁴⁴	
較	较	kɔ⁴⁴	白讀
酵	酵	kɔ⁴⁴	白讀
覺	觉	kɔ⁴⁴	睡覺
敲	敲	kʰɔ⁵¹	
考	考	kʰɔ³⁴	
烤	烤	kʰɔ³⁴	
靠	靠	kʰɔ⁴⁴	
犒	犒	kʰɔ⁴⁴	
搞	搞	ɡɔ¹³	
熬	熬	ŋɔ²²	
傲	傲	ŋɔ¹³	
咬	咬	ŋɔ¹³	
蒿	蒿	hɔ⁵¹	
好	好	hɔ³⁴	好壞
好	好	hɔ⁴⁴	喜好
耗	耗	hɔ⁴⁴	
孝	孝	hɔ⁴⁴	白讀
豪	豪	ɦɔ²²	
壕	壕	ɦɔ²²	
毫	毫	ɦɔ²²	
浩	浩	ɦɔ¹³	
號	号	ɦɔ¹³	
坳	坳	ɔ⁵¹	
襖	袄	ɔ³⁴	
奧	奥	ɔ⁴⁴	
懊	懊	ɔ⁴⁴	
巴	巴	po⁵¹	
芭	芭	po⁵¹	
把	把	po³⁴	
疤	疤	po⁴⁴	
霸	霸	po⁴⁴	
壩	坝	po⁴⁴	
怕	怕	pʰo⁴⁴	
爬	爬	bo²²	
琶	琶	bo²²	
杷	杷	bo²²	
鈀	钯	bo¹³	
耙	耙	bo¹³	
稗	稗	bo¹³	
嬤	嬷	ʔmo⁴⁴	嬤嬤：姑媽，面稱
麻	麻	mo²²	
痲	痲	mo²²	
蟆	蟆	mo²²	
嬤	嬷	mo²²	稱呼，如：姑嬤（丈夫的姐妹）、姨嬤（妻子的姐妹）
馬	马	mo¹³	
碼	码	mo¹³	
罵	骂	mo¹³	
朵	朵	to³⁴	
躲	躲	to³⁴	
☐	☐	tʰo³⁴	（用手）捻，（用腳底）蹭擦
大	大	do¹³	大家
楂	楂	tso⁵¹	山楂
渣	渣	tso⁵¹	
遮	遮	tso⁵¹	
揸	揸	tso³⁴	抓，如：揸牌
詐	诈	tso⁴⁴	
榨	榨	tso⁴⁴	
炸	炸	tso⁴⁴	
蔗	蔗	tso⁴⁴	
叉	叉	tsʰo⁵¹	
杈	杈	tsʰo⁵¹	
差	差	tsʰo⁵¹	差別，差不多
車	车	tsʰo⁵¹	車輛
扯	扯	tsʰo³⁴	
岔	岔	tsʰo⁴⁴	
茶	茶	dzo²²	
搽	搽	dzo²²	
茬	茬	dzo²²	
查	查	dzo²²	調查
社	社	dzo¹³	
女	女	no²²	如：兒女、女孫（孫女）
哪	哪	no¹³	哪吒
蓑	蓑	so⁵¹	
沙	沙	so⁵¹	
紗	纱	so⁵¹	
奢	奢	so⁵¹	
賒	赊	so⁵¹	
捨	捨	so³⁴	
所	所	so³⁴	
赦	赦	so⁴⁴	
舍	舍	so⁴⁴	
蛇	蛇	zo²²	
佘	佘	zo²²	姓
射	射	zo¹³	
麝	麝	zo¹³	麝香
惹	惹	zo¹³	
家	家	ko⁵¹	白讀
加	加	ko⁵¹	
嘉	嘉	ko⁵¹	白讀
瓜	瓜	ko⁵¹	
假	假	ko³⁴	真假
寡	寡	ko³⁴	白讀
剮	剐	ko³⁴	白讀
假	假	ko⁴⁴	放假
架	架	ko⁴⁴	
駕	驾	ko⁴⁴	白讀
嫁	嫁	ko⁴⁴	
稼	稼	ko⁴⁴	白讀
價	价	ko⁴⁴	
掛	挂	ko⁴⁴	
卦	卦	ko⁴⁴	
誇	誇	kʰo⁵¹	
夸	夸	kʰo⁵¹	
侉	侉	kʰo³⁴	
垮	垮	kʰo³⁴	
揢	揢	kʰo⁴⁴	捕，捉，拿住
跨	跨	kʰo⁴⁴	
☐	☐	ɡo¹³	☐☐：開水，兒童用語
牙	牙	ŋo²²	
芽	芽	ŋo²²	
衙	衙	ŋo²²	
我	我	ŋo¹³	
砑	砑	ŋo¹³	砑平
瓦	瓦	ŋo¹³	
瓦	瓦	ŋo¹³	動詞
膘	膘	pio⁵¹	
標	标	pio⁵¹	
彪	彪	pio⁵¹	
表	表	pio³⁴	
飄	飘	pʰio⁵¹	
漂	漂	pʰio³⁴	漂白
票	票	pʰio⁴⁴	
漂	漂	pʰio⁴⁴	漂亮
瓢	瓢	bio²²	
嫖	嫖	bio²²	
鰾	鳔	bio¹³	
苗	苗	mio²²	
描	描	mio²²	
藐	藐	mio¹³	
渺	渺	mio¹³	
秒	秒	mio¹³	
廟	庙	mio¹³	
妙	妙	mio¹³	
刁	刁	tio⁵¹	
貂	貂	tio⁵¹	
雕	雕	tio⁵¹	
鳥	鸟	tio³⁴	白讀
釣	钓	tio⁴⁴	
吊	吊	tio⁴⁴	
挑	挑	tʰio⁵¹	
挑	挑	tʰio³⁴	給人輕易便能成功地機會
跳	跳	tʰio⁴⁴	
糶	粜	tʰio⁴⁴	
條	条	dio²²	
掉	掉	dio¹³	
調	调	dio¹³	
聊	聊	lio²²	
遼	辽	lio²²	
撩	撩	lio²²	
廖	廖	lio²²	
燎	燎	lio¹³	
療	疗	lio¹³	
了	了	lio¹³	瞭解，了結
瞭	瞭	lio¹³	
料	料	lio¹³	
交	交	tɕio⁵¹	文讀
郊	郊	tɕio⁵¹	
焦	焦	tɕio⁵¹	
蕉	蕉	tɕio⁵¹	
椒	椒	tɕio⁵¹	
朝	朝	tɕio⁵¹	今朝
昭	昭	tɕio⁵¹	
招	招	tɕio⁵¹	
驕	骄	tɕio⁵¹	
嬌	娇	tɕio⁵¹	
澆	浇	tɕio⁵¹	
餃	饺	tɕio⁵¹	餃子
狡	狡	tɕio³⁴	
剿	剿	tɕio³⁴	
沼	沼	tɕio³⁴	
矯	矫	tɕio³⁴	
繳	缴	tɕio³⁴	
僥	侥	tɕio³⁴	
教	教	tɕio⁴⁴	教育，教師
校	校	tɕio⁴⁴	校對
較	较	tɕio⁴⁴	文讀
酵	酵	tɕio⁴⁴	文讀
照	照	tɕio⁴⁴	
詔	诏	tɕio⁴⁴	
叫	叫	tɕio⁴⁴	
鍬	锹	tɕʰio⁵¹	
繰	繰	tɕʰio⁵¹	繰邊
超	超	tɕʰio⁵¹	
巧	巧	tɕʰio³⁴	
悄	悄	tɕʰio⁴⁴	
俏	俏	tɕʰio⁴⁴	
竅	窍	tɕʰio⁴⁴	
樵	樵	dʑio²²	
朝	朝	dʑio²²	朝代
潮	潮	dʑio²²	
趙	赵	dʑio²²	
喬	乔	dʑio²²	
僑	侨	dʑio²²	
橋	桥	dʑio²²	
蕎	荞	dʑio²²	
轎	轿	dʑio¹³	
饒	饶	ȵio²²	
堯	尧	ȵio²²	
擾	扰	ȵio¹³	
繞	绕	ȵio¹³	
鳥	鸟	ȵio¹³	文讀
尿	尿	ȵio¹³	
消	消	ɕio⁵¹	
宵	宵	ɕio⁵¹	
霄	霄	ɕio⁵¹	
硝	硝	ɕio⁵¹	
銷	销	ɕio⁵¹	
燒	烧	ɕio⁵¹	
枵	枵	ɕio⁵¹	
囂	嚣	ɕio⁵¹	
蕭	萧	ɕio⁵¹	
簫	箫	ɕio⁵¹	
小	小	ɕio³⁴	
少	少	ɕio³⁴	多少
曉	晓	ɕio³⁴	
孝	孝	ɕio⁴⁴	文讀
笑	笑	ɕio⁴⁴	
鞘	鞘	ɕio⁴⁴	
少	少	ɕio⁴⁴	少年
韶	韶	ʑio¹³	
紹	绍	ʑio¹³	
邵	邵	ʑio¹³	
餚	肴	ɦio²²	
淆	淆	ɦio²²	
搖	摇	ɦio²²	
謠	谣	ɦio²²	
窯	窑	ɦio²²	
姚	姚	ɦio²²	
效	效	ɦio¹³	
校	校	ɦio¹³	學校
校	校	ɦio¹³	上校
兆	兆	ɦio¹³	
召	召	ɦio¹³	
耀	耀	ɦio¹³	
鷂	鹞	ɦio¹³	
妖	妖	io⁵¹	
邀	邀	io⁵¹	
腰	腰	io⁵¹	
要	要	io⁵¹	要求
幺	幺	io⁵¹	幺二三
吆	吆	io⁵¹	吆喝
舀	舀	io³⁴	舀水
杳	杳	io³⁴	
要	要	io⁴⁴	想要，重要
哈	哈	huo⁵¹	哈欠
花	花	huo⁵¹	
蝦	虾	huo³⁴	
化	化	huo⁴⁴	
霞	霞	ɦuo²²	白讀，如：霞浦張，地名
華	华	ɦuo²²	中華
鏵	铧	ɦuo²²	
下	下	ɦuo¹³	
夏	夏	ɦuo¹³	姓
夏	夏	ɦuo¹³	春夏
廈	厦	ɦuo¹³	
暇	暇	ɦuo¹³	
華	华	ɦuo¹³	華山，姓
樺	桦	ɦuo¹³	
畫	画	ɦuo¹³	
話	话	ɦuo¹³	
鴉	鸦	uo⁵¹	白讀
丫	丫	uo⁵¹	丫頭
椏	椏	uo⁵¹	椏杈
划	划	uo⁵¹	划船
蛙	蛙	uo⁵¹	
窪	洼	uo⁵¹	
啞	哑	uo³⁴	
掗	挜	uo⁴⁴	掗賣：強賣
爹	爹	te⁵¹	
呆	呆	te⁵¹	呆滯
戴	戴	te⁴⁴	姓，愛戴
胎	胎	tʰe⁵¹	
台	台	tʰe⁵¹	天台，台州
苔	苔	tʰe⁵¹	舌苔
梯	梯	tʰe⁵¹	白讀
態	态	tʰe⁴⁴	
貸	贷	tʰe⁴⁴	
臺	台	de²²	
苔	苔	de²²	青苔
擡	抬	de²²	
貸	贷	de¹³	又音
待	待	de¹³	
怠	怠	de¹³	
殆	殆	de¹³	
代	代	de¹³	
袋	袋	de¹³	
來	来	le²²	
災	灾	tse⁵¹	
栽	栽	tse⁵¹	
齋	斋	tse⁵¹	
皆	皆	tse⁵¹	
階	阶	tse⁵¹	文讀
宰	宰	tse³⁴	
載	载	tse³⁴	年載
再	再	tse⁴⁴	
載	载	tse⁴⁴	載重
載	载	tse⁴⁴	滿載
猜	猜	tsʰe⁵¹	
且	且	tsʰe³⁴	
彩	彩	tsʰe³⁴	
採	採	tsʰe³⁴	
睬	睬	tsʰe³⁴	
菜	菜	tsʰe⁴⁴	
才	才	dze²²	
材	材	dze²²	
財	财	dze²²	
茄	茄	dze¹³	茄子
在	在	dze¹³	
驗	验	ne¹³	又音，新
念	念	ne¹³	
耐	耐	ne¹³	
裁	裁	ze²²	
該	该	ke⁵¹	
改	改	ke³⁴	
概	概	ke⁴⁴	
溉	溉	ke⁴⁴	
蓋	盖	ke⁴⁴	
丐	丐	ke⁴⁴	
開	开	kʰe⁵¹	
凱	凯	kʰe³⁴	
慨	慨	kʰe³⁴	
看	看	kʰe⁴⁴	表嘗試的標記詞，如：試試看
戤	戤	ɡe¹³	斜靠，依仗
呆	呆	ŋe²²	呆板
捱	捱	ŋe²²	捱打，捱罵
礙	碍	ŋe¹³	
艾	艾	ŋe¹³	
岸	岸	ŋe¹³	
海	海	he³⁴	
孩	孩	ɦe²²	
諧	谐	ɦe²²	又音
亥	亥	ɦe¹³	
害	害	ɦe¹³	
駭	骇	ɦe¹³	
械	械	ɦe¹³	又音
懈	懈	ɦe¹³	
哀	哀	e⁵¹	
埃	埃	e⁵¹	塵埃
愛	爱	e⁴⁴	
藹	蔼	e⁴⁴	和藹
班	班	pɛ⁵¹	
斑	斑	pɛ⁵¹	
頒	颁	pɛ⁵¹	
扳	扳	pɛ⁵¹	
般	般	pɛ⁵¹	
板	板	pɛ³⁴	
版	版	pɛ³⁴	
扮	扮	pɛ⁴⁴	
絆	绊	pɛ⁴⁴	
攀	攀	pʰɛ⁵¹	
盼	盼	pʰɛ⁴⁴	
襻	襻	pʰɛ⁴⁴	紐襻
帕	帕	pʰɛ⁴⁴	兒化音，如：絹帕（手帕）
爿	爿	bɛ²²	
牌	牌	bɛ¹³	兒化音
瓣	瓣	bɛ¹³	
辦	办	bɛ¹³	
蠻	蛮	ʔmɛ⁵¹	很
埋	埋	mɛ²²	
蠻	蛮	mɛ²²	
邁	迈	mɛ¹³	
貓	猫	mɛ¹³	兒化音
慢	慢	mɛ¹³	
漫	漫	mɛ¹³	又音
幔	幔	mɛ¹³	又音
晚	晚	mɛ¹³	白讀
萬	万	mɛ¹³	麻將牌
蔓	蔓	mɛ¹³	
藩	藩	fɛ⁵¹	
翻	翻	fɛ⁵¹	
番	番	fɛ⁵¹	
覅	覅	fɛ⁵¹	不要
反	反	fɛ³⁴	
泛	泛	fɛ⁴⁴	
販	贩	fɛ⁴⁴	
凡	凡	vɛ²²	
帆	帆	vɛ²²	
煩	烦	vɛ²²	
礬	矾	vɛ²²	
繁	繁	vɛ²²	
範	范	vɛ¹³	
犯	犯	vɛ¹³	
飯	饭	vɛ¹³	
晚	晚	vɛ¹³	文讀
萬	万	vɛ¹³	
耽	耽	tɛ⁵¹	
擔	担	tɛ⁵¹	擔任
丹	丹	tɛ⁵¹	
單	单	tɛ⁵¹	
膽	胆	tɛ³⁴	
撣	掸	tɛ³⁴	雞毛撣子
擔	担	tɛ⁴⁴	挑擔
旦	旦	tɛ⁴⁴	
貪	贪	tʰɛ⁵¹	又音
坍	坍	tʰɛ⁵¹	
灘	滩	tʰɛ⁵¹	
攤	摊	tʰɛ⁵¹	
毯	毯	tʰɛ³⁴	
坦	坦	tʰɛ³⁴	
探	探	tʰɛ⁴⁴	又音
炭	炭	tʰɛ⁴⁴	
嘆	叹	tʰɛ⁴⁴	
潭	潭	dɛ²²	又音
譚	谭	dɛ²²	
談	谈	dɛ²²	
檀	檀	dɛ²²	
壇	坛	dɛ²²	
彈	弹	dɛ²²	彈琴
痰	痰	dɛ¹³	
淡	淡	dɛ¹³	
誕	诞	dɛ¹³	
但	但	dɛ¹³	
彈	弹	dɛ¹³	子彈
蛋	蛋	dɛ¹³	
藍	蓝	lɛ²²	
籃	篮	lɛ²²	
蘭	兰	lɛ²²	
攔	拦	lɛ²²	
欄	栏	lɛ²²	
覽	览	lɛ¹³	
攬	揽	lɛ¹³	
欖	榄	lɛ¹³	
濫	滥	lɛ¹³	
纜	缆	lɛ¹³	
懶	懒	lɛ¹³	
爛	烂	lɛ¹³	
簪	簪	tsɛ⁵¹	又音
斬	斩	tsɛ⁵¹	
盞	盏	tsɛ³⁴	
蘸	蘸	tsɛ⁴⁴	
贊	赞	tsɛ⁴⁴	
灒	灒	tsɛ⁴⁴	濺
參	参	tsʰɛ⁵¹	文讀
攙	搀	tsʰɛ⁵¹	
慘	惨	tsʰɛ³⁴	
鏟	铲	tsʰɛ³⁴	
產	产	tsʰɛ³⁴	
餐	餐	tsʰɛ⁴⁴	
燦	灿	tsʰɛ⁴⁴	
慚	惭	dzɛ²²	
讒	谗	dzɛ²²	
饞	馋	dzɛ²²	
殘	残	dzɛ²²	
暫	暂	dzɛ¹³	
站	站	dzɛ¹³	
賺	赚	dzɛ¹³	
綻	绽	dzɛ¹³	
棧	栈	dzɛ¹³	
奶	奶	ʔnɛ⁴⁴	兒化音，如：奶奶（乳汁）
難	难	nɛ²²	難易
難	难	nɛ¹³	患難
腮	腮	sɛ⁵¹	
鰓	鳃	sɛ⁵¹	
衰	衰	sɛ⁵¹	
三	三	sɛ⁵¹	
杉	杉	sɛ⁵¹	
衫	衫	sɛ⁵¹	
珊	珊	sɛ⁵¹	
山	山	sɛ⁵¹	
刪	删	sɛ⁵¹	
賽	赛	sɛ⁴⁴	
帥	帅	sɛ⁴⁴	
散	散	sɛ⁴⁴	
傘	伞	sɛ⁴⁴	
疝	疝	sɛ⁴⁴	
饞	馋	zɛ²²	饞唾水：唾沫
僝	僝	zɛ¹³	責罵、訓斥
尷	尴	kɛ⁵¹	
監	监	kɛ⁵¹	監察，監視，監牢
奸	奸	kɛ⁵¹	
間	间	kɛ⁵¹	房間，車間
橄	橄	kɛ³⁴	
減	减	kɛ³⁴	
礆	硷	kɛ³⁴	
襉	裥	kɛ³⁴	
揀	拣	kɛ³⁴	
監	监	kɛ⁴⁴	國子監
堪	堪	kʰɛ⁵¹	
龕	龛	kʰɛ⁵¹	
艦	舰	kʰɛ⁵¹	
刊	刊	kʰɛ⁵¹	
鉛	铅	kʰɛ⁵¹	
坎	坎	kʰɛ³⁴	
砍	砍	kʰɛ³⁴	
勘	勘	kʰɛ⁴⁴	
嵌	嵌	kʰɛ⁴⁴	
諫	谏	ɡɛ¹³	嘮叨，如：諫嘴諫得
巖	岩	ŋɛ²²	
顏	颜	ŋɛ²²	
眼	眼	ŋɛ¹³	
喊	喊	hɛ³⁴	
莧	苋	hɛ⁴⁴	莧菜
鹹	咸	ɦɛ²²	
銜	衔	ɦɛ²²	
閒	闲	ɦɛ²²	
閑	闲	ɦɛ²²	
陷	陷	ɦɛ¹³	
餡	馅	ɦɛ¹³	
限	限	ɦɛ¹³	
鴨	鸭	ɛ³⁴	兒化音
晏	晏	ɛ⁴⁴	晚
鰥	鳏	kuɛ⁵¹	
關	关	kuɛ⁵¹	
慣	惯	kuɛ⁴⁴	
筷	筷	kʰuɛ⁴⁴	
環	环	ɡuɛ¹³	白讀
摜	掼	ɡuɛ¹³	
儇	儇	huɛ⁵¹	聰明
甩	甩	huɛ⁴⁴	搖；如：甩頭（表示否定、無奈）
懷	怀	ɦuɛ²²	文讀，又音
槐	槐	ɦuɛ²²	又音
淮	淮	ɦuɛ²²	又音
玩	玩	ɦuɛ²²	古玩，遊玩；又音
頑	顽	ɦuɛ²²	
還	还	ɦuɛ²²	
幻	幻	ɦuɛ¹³	
環	环	ɦuɛ¹³	文讀
患	患	ɦuɛ¹³	
宦	宦	ɦuɛ¹³	
彎	弯	uɛ⁵¹	
灣	湾	uɛ⁵¹	
挽	挽	uɛ³⁴	
娃	娃	uɛ³⁴	兒化音；男孩
杯	杯	pai⁵¹	
碑	碑	pai⁵¹	
卑	卑	pai⁵¹	
悲	悲	pai⁵¹	
貝	贝	pai⁴⁴	
輩	辈	pai⁴⁴	
背	背	pai⁴⁴	
胚	胚	pʰai⁵¹	
坯	坯	pʰai⁵¹	
沛	沛	pʰai⁴⁴	
配	配	pʰai⁴⁴	
培	培	bai²²	
陪	陪	bai²²	
賠	赔	bai²²	
裴	裴	bai²²	
倍	倍	bai¹³	
佩	佩	bai¹³	
背	背	bai¹³	背誦
焙	焙	bai¹³	烘焙
被	被	bai¹³	被動
備	备	bai¹³	
梅	梅	mai²²	
枚	枚	mai²²	
媒	媒	mai²²	
煤	煤	mai²²	
眉	眉	mai²²	文讀
楣	楣	mai²²	
黴	霉	mai²²	
霉	霉	mai²²	
謎	谜	mai²²	兒化音，如：謎子（謎語）
每	每	mai¹³	
妹	妹	mai¹³	
昧	昧	mai¹³	
美	美	mai¹³	
媚	媚	mai¹³	
寐	寐	mai¹³	
𣍐	𣍐	vai²²	不會
堆	堆	tai⁵¹	
𠡒	𠡒	tai⁵¹	拉扯；𠡒腳：扯後腿
對	对	tai⁵¹	
推	推	tʰai⁵¹	
貪	贪	tʰai⁵¹	
腿	腿	tʰai³⁴	
退	退	tʰai⁴⁴	
蛻	蜕	tʰai⁴⁴	
探	探	tʰai⁴⁴	
窞	窞	dai²²	低窪、凹下的地方
頭	头	dai²²	頭兒化音，如：老頭伯
隊	队	dai¹³	
兌	兑	dai¹³	
雷	雷	lai²²	
屢	屡	lai¹³	
儡	儡	lai¹³	
累	累	lai¹³	
壘	垒	lai¹³	
類	类	lai¹³	
最	最	tsai⁵¹	
追	追	tsai⁵¹	
錐	锥	tsai⁵¹	
簪	簪	tsai⁵¹	
綴	缀	tsai⁴⁴	
贅	赘	tsai⁴⁴	
醉	醉	tsai⁴⁴	
催	催	tsʰai⁵¹	
崔	崔	tsʰai⁵¹	
吹	吹	tsʰai⁵¹	文讀
炊	炊	tsʰai⁵¹	
參	参	tsʰai⁵¹	白讀；參隊：交朋友
𢶀	𢶀	tsʰai³⁴	扭扯；如：𢶀頭髮、𢶀耳朵
脆	脆	tsʰai⁴⁴	
翠	翠	tsʰai⁴⁴	
粹	粹	tsʰai⁴⁴	又音
☐	☐	dzai¹³	咋會合音；怎麼會
南	南	nai²²	
男	男	nai²²	
內	内	nai¹³	
雖	虽	sai⁵¹	
綏	绥	sai⁵¹	
髓	髓	sai³⁴	
水	水	sai³⁴	文讀
碎	碎	sai⁴⁴	
歲	岁	sai⁴⁴	文讀
稅	税	sai⁴⁴	
粹	粹	sai⁴⁴	
隨	随	zai²²	
垂	垂	zai²²	
罪	罪	zai¹³	
芮	芮	zai¹³	
銳	锐	zai¹³	
睡	睡	zai¹³	
瑞	瑞	zai¹³	
蕊	蕊	zai¹³	文讀
遂	遂	zai¹³	
隧	隧	zai¹³	
穗	穗	zai¹³	
誰	谁	zai¹³	
蠶	蚕	zai¹³	
蚶	蚶	hai⁵¹	蚶子
憨	憨	hai⁵¹	癡；戇憨憨：傻乎乎
鼾	鼾	hai⁵¹	
罕	罕	hai³⁴	
許	许	hai³⁴	白讀，如：許配
漢	汉	hai⁴⁴	
含	含	ɦai²²	
函	函	ɦai²²	
寒	寒	ɦai²²	
韓	韩	ɦai²²	
撼	撼	ɦai¹³	
憾	憾	ɦai¹³	
旱	旱	ɦai¹³	
汗	汗	ɦai¹³	
焊	焊	ɦai¹³	
翰	翰	ɦai¹³	
庵	庵	ai⁵¹	
安	安	ai⁵¹	
鞍	鞍	ai⁵¹	
暗	暗	ai⁴⁴	
按	按	ai⁴⁴	
案	案	ai⁴⁴	
圭	圭	kuai⁵¹	
閨	闺	kuai⁵¹	
規	规	kuai⁵¹	
龜	龟	kuai⁵¹	文讀
歸	归	kuai⁵¹	
詭	诡	kuai³⁴	
軌	轨	kuai³⁴	
癸	癸	kuai³⁴	
鬼	鬼	kuai³⁴	文讀
鱖	鳜	kuai⁴⁴	
桂	桂	kuai⁴⁴	
葵	葵	kuai⁴⁴	又音
貴	贵	kuai⁴⁴	文讀
盔	盔	kʰuai⁵¹	
魁	魁	kʰuai⁵¹	
奎	奎	kʰuai⁵¹	
虧	亏	kʰuai⁵¹	
窺	窥	kʰuai⁵¹	
傀	傀	kʰuai³⁴	
蒯	蒯	kʰuai⁴⁴	
塊	块	kʰuai⁴⁴	
愧	愧	kʰuai⁴⁴	
逵	逵	ɡuai²²	
葵	葵	ɡuai²²	
潰	溃	ɡuai¹³	
跪	跪	ɡuai¹³	文讀
櫃	柜	ɡuai¹³	文讀
恢	恢	huai⁵¹	
灰	灰	huai⁵¹	
麾	麾	huai⁵¹	
揮	挥	huai⁵¹	
輝	辉	huai⁵¹	
徽	徽	huai⁵¹	
賄	贿	huai³⁴	
悔	悔	huai³⁴	
毀	毁	huai³⁴	
晦	晦	huai⁴⁴	
諱	讳	huai⁴⁴	
桅	桅	ɦuai²²	
回	回	ɦuai²²	
茴	茴	ɦuai²²	
危	危	ɦuai²²	
爲	为	ɦuai²²	作爲
為	为	ɦuai²²	作爲
違	违	ɦuai²²	
圍	围	ɦuai²²	
匯	汇	ɦuai¹³	
會	会	ɦuai¹³	
繪	绘	ɦuai¹³	
惠	惠	ɦuai¹³	
慧	慧	ɦuai¹³	
衛	卫	ɦuai¹³	
穢	秽	ɦuai¹³	
僞	伪	ɦuai¹³	
偽	伪	ɦuai¹³	
爲	为	ɦuai¹³	
為	为	ɦuai¹³	
位	位	ɦuai¹³	
魏	魏	ɦuai¹³	
偉	伟	ɦuai¹³	
葦	苇	ɦuai¹³	
緯	纬	ɦuai¹³	
胃	胃	ɦuai¹³	
謂	谓	ɦuai¹³	
蝟	蝟	ɦuai¹³	
彙	彙	ɦuai¹³	
煨	煨	uai⁵¹	
萎	萎	uai⁵¹	
威	威	uai⁵¹	
委	委	uai³⁴	
喂	喂	uai⁴⁴	文讀
畏	畏	uai⁴⁴	
慰	慰	uai⁴⁴	
波	波	pau⁵¹	
菠	菠	pau⁵¹	
玻	玻	pau⁵¹	
簸	簸	pau⁴⁴	
頗	颇	pʰau⁵¹	
坡	坡	pʰau⁵¹	
破	破	pʰau⁴⁴	
剖	剖	pʰau⁴⁴	
婆	婆	bau²²	
薄	薄	bau¹³	薄荷
縛	缚	bau¹³	捆綁
魔	魔	mau²²	
磨	磨	mau²²	動詞
摩	摩	mau²²	
饃	馍	mau²²	
模	模	mau²²	
摹	摹	mau²²	
磨	磨	mau¹³	名詞
暮	暮	mau¹³	
慕	慕	mau¹³	
墓	墓	mau¹³	
募	募	mau¹³	
某	某	mau¹³	
膜	膜	mau¹³	又音
幕	幕	mau¹³	又音
多	多	tau⁵¹	
拖	拖	tʰau⁵¹	
妥	妥	tʰau³⁴	
橢	椭	tʰau³⁴	
唾	唾	tʰau⁴⁴	
駝	驼	dau²²	
馱	驮	dau²²	拿
舵	舵	dau¹³	
大	大	dau¹³	白
惰	惰	dau¹³	
垛	垛	dau¹³	
囉	啰	ʔlau⁴⁴	囉嗦
羅	罗	lau²²	
鑼	锣	lau²²	
籮	箩	lau²²	
騾	骡	lau²²	
螺	螺	lau²²	螺螄
腡	脶	lau²²	手指文
裸	裸	lau¹³	
摞	摞	lau¹³	
虜	虏	lau¹³	
擄	掳	lau¹³	
左	左	tsau³⁴	
佐	佐	tsau³⁴	
做	做	tsau⁴⁴	
搓	搓	tsʰau⁵¹	
銼	锉	tsʰau⁴⁴	
錯	错	tsʰau⁴⁴	
挪	挪	nau²²	
糯	糯	nau¹³	
梭	梭	sau⁵¹	
唆	唆	sau⁵¹	囉唆
鎖	锁	sau³⁴	
瑣	琐	sau³⁴	
啥	啥	sau⁴⁴	什麼；啥人：誰
坐	坐	zau¹³	
座	座	zau¹³	
歌	歌	kau⁵¹	
哥	哥	kau⁵¹	
鍋	锅	kau⁵¹	
戈	戈	kau⁵¹	
蝸	蜗	kau⁵¹	
果	果	kau³⁴	
裹	裹	kau³⁴	
餜	馃	kau³⁴	
個	个	kau⁴⁴	個人，一個
過	过	kau⁴⁴	
科	科	kʰau⁵¹	
窠	窠	kʰau⁵¹	
棵	棵	kʰau⁵¹	
可	可	kʰau³⁴	
顆	颗	kʰau³⁴	
課	课	kʰau⁴⁴	
俄	俄	ŋau²²	
訛	讹	ŋau²²	
蛾	蛾	ŋau¹³	
鵝	鹅	ŋau¹³	
我	我	ŋau¹³	柴橋等地讀音
餓	饿	ŋau¹³	
臥	卧	ŋau¹³	
火	火	hau⁵¹	動詞，發火
火	火	hau³⁴	
夥	夥	hau³⁴	
荷	荷	hau⁴⁴	薄荷
貨	货	hau⁴⁴	
河	河	ɦau²²	
何	何	ɦau²²	
荷	荷	ɦau²²	荷花
和	和	ɦau²²	和氣
禾	禾	ɦau²²	
賀	贺	ɦau¹³	
禍	祸	ɦau¹³	
和	和	ɦau¹³	和麪
阿	阿	au⁵¹	阿膠
倭	倭	au⁵¹	
窩	窝	au⁵¹	
捼	捼	au³⁴	抱
涴	涴	au⁴⁴	
屙	屙	au⁴⁴	糞便
搬	搬	pøy⁵¹	
半	半	pøy⁴⁴	
巴	巴	pøy⁴⁴	兒化音，如：尾巴
潘	潘	pʰøy⁵¹	
判	判	pʰøy⁴⁴	
盤	盘	bøy²²	
婆	婆	bøy²²	兒化，如：老太婆
伴	伴	bøy¹³	
拌	拌	bøy¹³	
叛	叛	bøy¹³	
謀	谋	møy²²	
矛	矛	møy²²	
瞞	瞒	møy²²	
饅	馒	møy²²	
畝	亩	møy¹³	文讀
牡	牡	møy¹³	
母	母	møy¹³	文讀
拇	拇	møy¹³	
茂	茂	møy¹³	
貿	贸	møy¹³	
滿	满	møy¹³	
漫	漫	møy¹³	
幔	幔	møy¹³	
否	否	føy³⁴	
負	负	vøy¹³	
兜	兜	tøy⁵¹	
端	端	tøy⁵¹	
斗	斗	tøy³⁴	
抖	抖	tøy³⁴	
陡	陡	tøy³⁴	
短	短	tøy³⁴	
鬥	斗	tøy⁴⁴	鬥爭
逗	逗	tøy⁴⁴	
斷	断	tøy⁴⁴	判斷
鍛	锻	tøy⁴⁴	鍛鍊
偷	偷	tʰøy⁵¹	
敨	敨	tʰøy³⁴	展開，敨氣
疃	疃	tʰøy³⁴	
透	透	tʰøy⁴⁴	
頭	头	døy²²	
投	投	døy²²	
團	团	døy²²	
糰	糰	døy²²	
豆	豆	døy¹³	
斷	断	døy¹³	斷絕
段	段	døy¹³	
緞	缎	døy¹³	
椴	椴	døy¹³	
鏤	镂	ʔløy⁵¹	摳、挖
樓	楼	løy²²	
鸞	鸾	løy²²	
簍	篓	løy¹³	
漏	漏	løy¹³	
陋	陋	løy¹³	
卵	卵	løy¹³	
亂	乱	løy¹³	
鄒	邹	tsøy⁵¹	
鑽	钻	tsøy⁵¹	動詞
專	专	tsøy⁵¹	
磚	砖	tsøy⁵¹	
走	走	tsøy³⁴	
纂	纂	tsøy³⁴	
轉	转	tsøy³⁴	
奏	奏	tsøy⁴⁴	
皺	皱	tsøy⁴⁴	
縐	绉	tsøy⁴⁴	
驟	骤	tsøy⁴⁴	
戰	战	tsøy⁴⁴	
顫	颤	tsøy⁴⁴	
鑽	钻	tsøy⁴⁴	名詞
川	川	tsʰøy⁵¹	
穿	穿	tsʰøy⁵¹	
喘	喘	tsʰøy³⁴	
湊	凑	tsʰøy⁴⁴	
汆	汆	tsʰøy⁴⁴	
竄	窜	tsʰøy⁴⁴	
篡	篡	tsʰøy⁴⁴	
串	串	tsʰøy⁴⁴	
蟬	蝉	dzøy²²	
禪	禅	dzøy²²	禪宗
全	全	dzøy²²	
泉	泉	dzøy²²	
賺	赚	dzøy¹³	又音，舊
撰	撰	dzøy¹³	
傳	传	dzøy¹³	
椽	椽	dzøy¹³	
篆	篆	dzøy¹³	
囡	囡	ʔnøy⁴⁴	暱稱嬰幼兒，“女”的兒化
囡	囡	nøy²²	女兒，“女”的兒化音
暖	暖	nøy¹³	
搜	搜	søy⁵¹	
颼	飕	søy⁵¹	
餿	馊	søy⁵¹	
酸	酸	søy⁵¹	
閂	闩	søy⁵¹	
拴	拴	søy⁵¹	
宣	宣	søy⁵¹	
叟	叟	søy³⁴	
陝	陕	søy³⁴	
選	选	søy³⁴	
嗽	嗽	søy⁴⁴	
瘦	瘦	søy⁴⁴	
算	算	søy⁴⁴	
蒜	蒜	søy⁴⁴	
涮	涮	søy⁴⁴	
愁	愁	zøy²²	
柔	柔	zøy²²	文讀
船	船	zøy²²	
羨	羡	zøy¹³	
善	善	zøy¹³	
膳	膳	zøy¹³	
單	单	zøy¹³	姓
禪	禅	zøy¹³	禪讓
然	然	zøy¹³	
燃	燃	zøy¹³	
旋	旋	zøy¹³	
勾	勾	køy⁵¹	
鉤	钩	køy⁵¹	
溝	沟	køy⁵¹	
狗	狗	køy³⁴	
苟	苟	køy³⁴	
夠	够	køy⁴⁴	
構	构	køy⁴⁴	
購	购	køy⁴⁴	
勾	勾	køy⁴⁴	勾當
摳	抠	kʰøy⁵¹	
瞘	眍	kʰøy⁵¹	
口	口	kʰøy³⁴	
叩	叩	kʰøy⁴⁴	
扣	扣	kʰøy⁴⁴	
寇	寇	kʰøy⁴⁴	
跔	跔	ɡøy²²	蜷縮；如：跔頭縮頸
牛	牛	ŋøy²²	白讀
藕	藕	ŋøy¹³	
偶	偶	ŋøy¹³	
吼	吼	høy⁵¹	急；發急、發火
吼	吼	høy³⁴	
鱟	鲎	høy⁴⁴	彩虹；一種海魚
侯	侯	ɦøy²²	
喉	喉	ɦøy²²	
猴	猴	ɦøy²²	
瘊	瘊	ɦøy²²	
后	后	ɦøy¹³	
後	后	ɦøy¹³	
厚	厚	ɦøy¹³	
候	候	ɦøy¹³	
歐	欧	øy⁵¹	
甌	瓯	øy⁵¹	
嘔	呕	øy⁵¹	叫、喊
嘔	呕	øy³⁴	
毆	殴	øy³⁴	
漚	沤	øy⁴⁴	
慪	怄	øy⁴⁴	
官	官	kuøy⁵¹	
棺	棺	kuøy⁵¹	
觀	观	kuøy⁵¹	
冠	冠	kuøy⁵¹	衣冠
管	管	kuøy³⁴	
館	馆	kuøy³⁴	
貫	贯	kuøy⁴⁴	
灌	灌	kuøy⁴⁴	
罐	罐	kuøy⁴⁴	
冠	冠	kuøy⁴⁴	冠軍
果	果	kuøy⁴⁴	兒化音，如：祭竈果
寬	宽	kʰuøy⁵¹	
款	款	kʰuøy³⁴	
歡	欢	huøy⁵¹	
蝦	虾	huøy³⁴	兒化
喚	唤	huøy⁴⁴	
煥	焕	huøy⁴⁴	
花	花	huøy⁴⁴	兒化音，如：奶花（嬰兒）
玩	玩	ɦuøy²²	
桓	桓	ɦuøy²²	
完	完	ɦuøy²²	
丸	丸	ɦuøy¹³	
緩	缓	ɦuøy¹³	
換	换	ɦuøy¹³	
幻	幻	ɦuøy¹³	又音
皖	皖	uøy³⁴	
豌	豌	uøy³⁴	
碗	碗	uøy³⁴	
腕	腕	uøy³⁴	
謬	谬	miu¹³	
丟	丢	tiu⁵¹	
溜	溜	ʔliu⁵¹	溜冰，新
流	流	liu²²	
劉	刘	liu²²	
留	留	liu²²	
榴	榴	liu²²	
硫	硫	liu²²	
琉	琉	liu²²	
柳	柳	liu¹³	
溜	溜	liu¹³	地滑
餾	馏	liu¹³	
揪	揪	tɕiu⁵¹	
鬏	鬏	tɕiu⁵¹	
鳩	鸠	tɕiu⁵¹	
鬮	阄	tɕiu⁵¹	
糾	纠	tɕiu⁵¹	
酒	酒	tɕiu³⁴	
肘	肘	tɕiu³⁴	
九	九	tɕiu³⁴	
久	久	tɕiu³⁴	
韭	韭	tɕiu³⁴	
灸	灸	tɕiu³⁴	
晝	昼	tɕiu⁴⁴	
救	救	tɕiu⁴⁴	
究	究	tɕiu⁴⁴	
箍	箍	tɕʰiu⁵¹	白讀
秋	秋	tɕʰiu⁵¹	
抽	抽	tɕʰiu⁵¹	
丘	丘	tɕʰiu⁵¹	
醜	丑	tɕʰiu³⁴	
臭	臭	tɕʰiu⁴⁴	
囚	囚	dʑiu²²	
泅	泅	dʑiu²²	打泅：游泳
綢	绸	dʑiu²²	
稠	稠	dʑiu²²	
籌	筹	dʑiu²²	
求	求	dʑiu²²	
球	球	dʑiu²²	
仇	仇	dʑiu²²	姓
就	就	dʑiu¹³	
紂	纣	dʑiu¹³	
宙	宙	dʑiu¹³	
臼	臼	dʑiu¹³	
舅	舅	dʑiu¹³	
咎	咎	dʑiu¹³	
舊	旧	dʑiu¹³	
柩	柩	dʑiu¹³	
牛	牛	ȵiu²²	文讀
柔	柔	ȵiu²²	白讀
紐	纽	ȵiu¹³	
扭	扭	ȵiu¹³	
修	修	ɕiu⁵¹	
羞	羞	ɕiu⁵¹	
休	休	ɕiu⁵¹	
朽	朽	ɕiu³⁴	
秀	秀	ɕiu⁴⁴	
繡	绣	ɕiu⁴⁴	
綉	绣	ɕiu⁴⁴	
鏽	锈	ɕiu⁴⁴	
銹	锈	ɕiu⁴⁴	
嗅	嗅	ɕiu⁴⁴	嗅覺，文讀
袖	袖	ʑiu¹³	
尤	尤	ɦiu²²	
郵	邮	ɦiu²²	
由	由	ɦiu²²	
油	油	ɦiu²²	
遊	游	ɦiu²²	
游	游	ɦiu²²	
猶	犹	ɦiu²²	
悠	悠	ɦiu²²	
有	有	ɦiu¹³	
友	友	ɦiu¹³	
又	又	ɦiu¹³	
右	右	ɦiu¹³	
佑	佑	ɦiu¹³	
酉	酉	ɦiu¹³	
莠	莠	ɦiu¹³	
誘	诱	ɦiu¹³	
柚	柚	ɦiu¹³	
釉	釉	ɦiu¹³	
憂	忧	iu⁵¹	
優	优	iu⁵¹	
幽	幽	iu⁵¹	
幼	幼	iu⁴⁴	
崩	崩	pã⁵¹	
浜	浜	pã⁵¹	
伯	伯	pã³⁴	兒化音
迸	迸	pã⁴⁴	迸裂
烹	烹	pʰã⁵¹	
碰	碰	pʰã⁴⁴	白讀，又音
朋	朋	bã²²	
彭	彭	bã²²	
膨	膨	bã²²	
棚	棚	bã²²	
蚌	蚌	bã¹³	
碰	碰	bã¹³	白讀
☐	☐	ʔmã⁴⁴	☐☐：飯；兒童語
虻	虻	mã²²	黃虻：牛虻
猛	猛	mã¹³	
孟	孟	mã¹³	
打	打	tã³⁴	
☐	☐	tʰã⁵¹	☐鑼：一種銅鑼
蕩	荡	dã¹³	遊蕩
冷	冷	lã¹³	
爭	争	tsã⁵¹	白讀
睜	睁	tsã⁵¹	白讀
掙	挣	tsã⁵¹	
撐	撑	tsʰã⁴⁴	
錚	铮	dzã¹³	錚亮
䂻	䂻	dzã¹³	塞
生	生	sã⁵¹	白讀
牲	牲	sã⁵¹	
甥	甥	sã⁵¹	
省	省	sã³⁴	
更	更	kã⁵¹	五更；白讀
粳	粳	kã⁵¹	粳米
庚	庚	kã⁵¹	
羹	羹	kã⁵¹	
耕	耕	kã⁵¹	
埂	埂	kã³⁴	田埂
耿	耿	kã³⁴	白讀
䢚	䢚	kã⁴⁴	（小動物）鑽入（洞中）
坑	坑	kʰã⁵¹	白讀，如：溪坑
揞	揞	kʰã⁴⁴	扔，又音
鯁	鲠	ɡã¹³	骨鯁在喉
硬	硬	ŋã¹³	
亨	亨	hã⁵¹	
夯	夯	hã⁴⁴	打夯
行	行	ɦã²²	行爲，白讀
杏	杏	ɦã²²	
行	行	ɦã¹³	品行，白讀
鶯	莺	ã⁵¹	白讀
櫻	樱	ã⁵¹	白讀
㹙	㹙	ã³⁴	牛犢
揞	揞	ã⁴⁴	扔
良	良	liã²²	
涼	凉	liã²²	
量	量	liã²²	量長短
糧	粮	liã²²	
梁	梁	liã²²	
樑	梁	liã²²	
粱	粱	liã²²	
兩	两	liã¹³	
亮	亮	liã¹³	
諒	谅	liã¹³	
輛	辆	liã¹³	
量	量	liã¹³	數量
將	将	tɕiã⁵¹	將來
張	张	tɕiã⁵¹	
疆	疆	tɕiã⁵¹	
僵	僵	tɕiã⁵¹	
姜	姜	tɕiã⁵¹	
礓	礓	tɕiã⁵¹	
繮	缰	tɕiã⁵¹	
雀	雀	tɕiã⁵¹	麻雀；兒化音
漿	浆	tɕiã³⁴	
蔣	蒋	tɕiã³⁴	
獎	奖	tɕiã³⁴	
槳	桨	tɕiã³⁴	
長	长	tɕiã³⁴	生長
漲	涨	tɕiã³⁴	
醬	酱	tɕiã⁴⁴	
將	将	tɕiã⁴⁴	大將
帳	帐	tɕiã⁴⁴	
賬	账	tɕiã⁴⁴	
脹	胀	tɕiã⁴⁴	
腳	脚	tɕiã⁴⁴	兒化音，如：拐腳（瘸子）
槍	枪	tɕʰiã⁵¹	
羌	羌	tɕʰiã⁵¹	
搶	抢	tɕʰiã³⁴	
廠	厂	tɕʰiã³⁴	
暢	畅	tɕʰiã⁴⁴	
詳	详	dʑiã²²	
長	长	dʑiã²²	長短
腸	肠	dʑiã²²	
場	场	dʑiã²²	
強	强	dʑiã²²	
强	强	dʑiã²²	
丈	丈	dʑiã¹³	
仗	仗	dʑiã¹³	
杖	杖	dʑiã¹³	
𤃀	𤃀	dʑiã¹³	洗，白讀
鮎	鲇	ȵiã²²	鮎魚，兒化
娘	娘	ȵiã²²	
孃	娘	ȵiã²²	
瓤	瓤	ȵiã²²	
釀	酿	ȵiã¹³	
壤	壤	ȵiã¹³	
攘	攘	ȵiã¹³	
嚷	嚷	ȵiã¹³	
讓	让	ȵiã¹³	
仰	仰	ȵiã¹³	
相	相	ɕiã⁵¹	互相
箱	箱	ɕiã⁵¹	
廂	厢	ɕiã⁵¹	
湘	湘	ɕiã⁵¹	
襄	襄	ɕiã⁵¹	
鑲	镶	ɕiã⁵¹	
香	香	ɕiã⁵¹	
鄉	乡	ɕiã⁵¹	
想	想	ɕiã³⁴	
鯗	鲞	ɕiã³⁴	
餉	饷	ɕiã³⁴	
享	享	ɕiã³⁴	
響	响	ɕiã³⁴	
相	相	ɕiã⁴⁴	相貌
向	向	ɕiã⁴⁴	
牆	墙	ʑiã²²	
祥	祥	ʑiã²²	
匠	匠	ʑiã¹³	
象	象	ʑiã¹³	
像	像	ʑiã¹³	
橡	橡	ʑiã¹³	
洋	洋	ɦiã²²	
烊	烊	ɦiã²²	融化
楊	杨	ɦiã²²	
陽	阳	ɦiã²²	
揚	扬	ɦiã²²	
瘍	疡	ɦiã²²	潰瘍
羊	羊	ɦiã¹³	
癢	痒	ɦiã¹³	
樣	样	ɦiã¹³	
央	央	iã⁵¹	
秧	秧	iã⁵¹	
殃	殃	iã⁵¹	
養	养	iã³⁴	
梗	梗	kuã³⁴	莖；量詞：根，條
挭	挭	kuã⁴⁴	塗抹（水泥、膠水等糊狀物）
☐	☐	ɡuã¹³	象聲詞，形容匆忙，如：☐☐奔
橫	横	huã⁴⁴	橫記橫記：走路搖晃、吊兒郎當的樣子
橫	横	ɦuã²²	橫直
橫	横	ɦuã¹³	蠻橫
橫	横	ɦuã¹³	順便拐到另一處；打橫：順便去辦另一件事情，也指趁機開小差
橫	横	uã⁵¹	橫對：蠻橫、不講理
幫	帮	pɔ̃⁵¹	
邦	邦	pɔ̃⁵¹	
榜	榜	pɔ̃³⁴	
綁	绑	pɔ̃³⁴	
謗	谤	pɔ̃⁴⁴	
胖	胖	pʰɔ̃⁴⁴	
滂	滂	bɔ̃²²	
旁	旁	bɔ̃²²	
螃	螃	bɔ̃²²	
龐	庞	bɔ̃²²	
傍	傍	bɔ̃¹³	
防	防	bɔ̃¹³	白讀
棒	棒	bɔ̃¹³	
忙	忙	mɔ̃²²	
芒	芒	mɔ̃²²	
茫	茫	mɔ̃²²	
盲	盲	mɔ̃²²	
莽	莽	mɔ̃¹³	
蟒	蟒	mɔ̃¹³	
網	网	mɔ̃¹³	
忘	忘	mɔ̃¹³	白讀
妄	妄	mɔ̃¹³	白讀
望	望	mɔ̃¹³	白讀
夢	梦	mɔ̃¹³	白讀
方	方	fɔ̃⁵¹	
肪	肪	fɔ̃⁵¹	
芳	芳	fɔ̃⁵¹	
仿	仿	fɔ̃³⁴	
妨	妨	fɔ̃³⁴	
紡	纺	fɔ̃³⁴	
仿	仿	fɔ̃³⁴	
放	放	fɔ̃⁴⁴	
訪	访	fɔ̃⁴⁴	
房	房	vɔ̃²²	
亡	亡	vɔ̃²²	
防	防	vɔ̃¹³	文讀
忘	忘	vɔ̃¹³	文讀
妄	妄	vɔ̃¹³	文讀
望	望	vɔ̃¹³	文讀
當	当	tɔ̃⁵¹	當時，應當
黨	党	tɔ̃³⁴	
擋	挡	tɔ̃³⁴	
當	当	tɔ̃⁴⁴	當作，典當
湯	汤	tʰɔ̃⁵¹	
倘	倘	tʰɔ̃³⁴	
躺	躺	tʰɔ̃³⁴	
燙	烫	tʰɔ̃⁴⁴	
趟	趟	tʰɔ̃⁴⁴	
堂	堂	dɔ̃²²	
棠	棠	dɔ̃²²	
螳	螳	dɔ̃²²	
唐	唐	dɔ̃²²	
糖	糖	dɔ̃²²	
塘	塘	dɔ̃²²	
蕩	荡	dɔ̃¹³	
宕	宕	dɔ̃¹³	
郎	郎	lɔ̃²²	
廊	廊	lɔ̃²²	
狼	狼	lɔ̃²²	
螂	螂	lɔ̃²²	
朗	朗	lɔ̃¹³	
浪	浪	lɔ̃¹³	
贓	赃	tsɔ̃⁵¹	
髒	脏	tsɔ̃⁵¹	
莊	庄	tsɔ̃⁵¹	
裝	装	tsɔ̃⁵¹	
章	章	tsɔ̃⁵¹	
樟	樟	tsɔ̃⁵¹	
樁	桩	tsɔ̃⁵¹	
掌	掌	tsɔ̃³⁴	
葬	葬	tsɔ̃⁴⁴	
壯	壮	tsɔ̃⁴⁴	
障	障	tsɔ̃⁴⁴	保障
瘴	瘴	tsɔ̃⁴⁴	
降	降	tsɔ̃⁴⁴	又音
倉	仓	tsʰɔ̃⁵¹	
蒼	苍	tsʰɔ̃⁵¹	
瘡	疮	tsʰɔ̃⁵¹	
昌	昌	tsʰɔ̃⁵¹	
菖	菖	tsʰɔ̃⁵¹	
窗	窗	tsʰɔ̃⁵¹	
闖	闯	tsʰɔ̃³⁴	
創	创	tsʰɔ̃⁴⁴	
唱	唱	tsʰɔ̃⁴⁴	
倡	倡	tsʰɔ̃⁴⁴	
藏	藏	dzɔ̃²²	隱藏
常	常	dzɔ̃²²	
嘗	尝	dzɔ̃²²	
償	偿	dzɔ̃²²	
藏	藏	dzɔ̃¹³	西藏
臟	脏	dzɔ̃¹³	
撞	撞	dzɔ̃¹³	
幢	幢	dzɔ̃¹³	
囊	囊	nɔ̃²²	
桑	桑	sɔ̃⁵¹	
霜	霜	sɔ̃⁵¹	
孀	孀	sɔ̃⁵¹	
商	商	sɔ̃⁵¹	
傷	伤	sɔ̃⁵¹	
雙	双	sɔ̃⁵¹	
嗓	嗓	sɔ̃³⁴	
搡	搡	sɔ̃³⁴	
爽	爽	sɔ̃³⁴	
賞	赏	sɔ̃³⁴	
喪	丧	sɔ̃⁴⁴	
牀	床	zɔ̃²²	
裳	裳	zɔ̃²²	衣裳
狀	状	zɔ̃¹³	
上	上	zɔ̃¹³	
尚	尚	zɔ̃¹³	
岡	冈	kɔ̃⁵¹	
崗	岗	kɔ̃⁵¹	
剛	刚	kɔ̃⁵¹	
綱	纲	kɔ̃⁵¹	
鋼	钢	kɔ̃⁵¹	
缸	缸	kɔ̃⁵¹	
槓	杠	kɔ̃⁵¹	
江	江	kɔ̃⁵¹	
豇	豇	kɔ̃⁵¹	
講	讲	kɔ̃³⁴	
港	港	kɔ̃³⁴	
降	降	kɔ̃⁴⁴	
康	康	kʰɔ̃⁵¹	
糠	糠	kʰɔ̃⁵¹	
慷	慷	kʰɔ̃⁵¹	
抗	抗	kʰɔ̃⁴⁴	
炕	炕	kʰɔ̃⁴⁴	
囥	囥	kʰɔ̃⁴⁴	藏
㽘	㽘	ɡɔ̃²²	農地兩畦之間凹下去的通道
扛	扛	ɡɔ̃²²	
戇	戆	ɡɔ̃¹³	傻
昂	昂	ŋɔ̃²²	
☐	☐	hɔ̃⁴⁴	朗☐：（雨水）稀疏
行	行	ɦɔ̃²²	行列，銀行
航	航	ɦɔ̃²²	
杭	杭	ɦɔ̃²²	
降	降	ɦɔ̃²²	降服，投降
項	项	ɦɔ̃¹³	
巷	巷	ɦɔ̃¹³	
盎	盎	ɔ̃⁵¹	
骯	肮	ɔ̃⁵¹	
䱀	䱀	ɔ̃⁵¹	
光	光	kuɔ̃⁵¹	
廣	广	kuɔ̃³⁴	
逛	逛	kuɔ̃⁴⁴	
匡	匡	kʰuɔ̃⁵¹	
筐	筐	kʰuɔ̃⁵¹	
眶	眶	kʰuɔ̃⁵¹	
礦	矿	kʰuɔ̃⁴⁴	
況	况	kʰuɔ̃⁴⁴	
礦	矿	kʰuɔ̃⁴⁴	
狂	狂	ɡuɔ̃²²	
荒	荒	huɔ̃⁵¹	
慌	慌	huɔ̃⁵¹	
謊	谎	huɔ̃³⁴	
晃	晃	huɔ̃³⁴	
黃	黄	ɦuɔ̃²²	
簧	簧	ɦuɔ̃²²	
皇	皇	ɦuɔ̃²²	
蝗	蝗	ɦuɔ̃²²	
亡	亡	ɦuɔ̃²²	又音
王	王	ɦuɔ̃²²	
往	往	ɦuɔ̃¹³	
旺	旺	ɦuɔ̃¹³	
汪	汪	uɔ̃⁵¹	
枉	枉	uɔ̃³⁴	
往	往	uɔ̃³⁴	又音
降	降	tɕyɔ̃⁴⁴	又音
崩	崩	pəŋ⁵¹	又音
本	本	pəŋ³⁴	
奔	奔	pəŋ⁴⁴	
錛	锛	pəŋ⁴⁴	
噴	喷	pʰəŋ⁵¹	噴水
烹	烹	pʰəŋ⁵¹	又音
噴	喷	pʰəŋ⁴⁴	噴香，噴嚏
盆	盆	bəŋ²²	
笨	笨	bəŋ¹³	
悶	闷	ʔməŋ⁴⁴	又音
蜈	蜈	məŋ²²	蜈蚣，白讀
門	门	məŋ²²	
蚊	蚊	məŋ²²	白讀
聞	闻	məŋ²²	白讀
萌	萌	məŋ²²	
盟	盟	məŋ²²	
悶	闷	məŋ¹³	
問	问	məŋ¹³	白讀
分	分	fəŋ⁵¹	
芬	芬	fəŋ⁵¹	
紛	纷	fəŋ⁵¹	
粉	粉	fəŋ³⁴	
糞	粪	fəŋ⁴⁴	
奮	奋	fəŋ⁴⁴	
焚	焚	vəŋ²²	
墳	坟	vəŋ²²	
文	文	vəŋ²²	
紋	纹	vəŋ²²	
蚊	蚊	vəŋ²²	文讀
聞	闻	vəŋ²²	文讀
憤	愤	vəŋ¹³	
忿	忿	vəŋ¹³	
份	份	vəŋ¹³	
吻	吻	vəŋ¹³	
刎	刎	vəŋ¹³	
問	问	vəŋ¹³	文讀
敦	敦	təŋ⁵¹	
墩	墩	təŋ⁵¹	
蹲	蹲	təŋ⁵¹	
登	登	təŋ⁵¹	
燈	灯	təŋ⁵¹	
等	等	təŋ³⁴	
頂	顶	təŋ³⁴	白讀，如：屋頂、樓頂
頓	顿	təŋ⁴⁴	
凳	凳	təŋ⁴⁴	
鐙	镫	təŋ⁴⁴	
吞	吞	tʰəŋ⁵¹	
氽	氽	tʰəŋ³⁴	油炸
褪	褪	tʰəŋ⁴⁴	
屯	屯	dəŋ²²	
豚	豚	dəŋ²²	
飩	饨	dəŋ²²	餛飩
臀	臀	dəŋ²²	
騰	腾	dəŋ²²	
謄	誊	dəŋ²²	
藤	藤	dəŋ²²	
疼	疼	dəŋ²²	
停	停	dəŋ²²	白讀，如：停晌（休息一會兒）
囤	囤	dəŋ¹³	
沌	沌	dəŋ¹³	
盾	盾	dəŋ¹³	
鈍	钝	dəŋ¹³	
遁	遁	dəŋ¹³	
鄧	邓	dəŋ¹³	
論	论	ləŋ²²	論語
侖	仑	ləŋ²²	
倫	伦	ləŋ²²	
淪	沦	ləŋ²²	
輪	轮	ləŋ²²	
論	论	ləŋ¹³	議論
楞	楞	ləŋ¹³	
愣	愣	ləŋ¹³	
尊	尊	tsəŋ⁵¹	
撙	撙	tsəŋ⁵¹	
遵	遵	tsəŋ⁵¹	
曾	曾	tsəŋ⁵¹	姓
增	增	tsəŋ⁵¹	
憎	憎	tsəŋ⁵¹	
爭	争	tsəŋ⁵¹	文讀
箏	筝	tsəŋ⁵¹	
睜	睁	tsəŋ⁵¹	文讀
參	参	tsʰəŋ⁵¹	參差
忖	忖	tsʰəŋ³⁴	
襯	衬	tsʰəŋ⁴⁴	
村	村	tsʰəŋ⁴⁴	
寸	寸	tsʰəŋ⁴⁴	
岑	岑	dzəŋ²²	
存	存	dzəŋ²²	
曾	曾	dzəŋ²²	曾經
澄	澄	dzəŋ²²	
橙	橙	dzəŋ²²	
贈	赠	dzəŋ¹³	
能	能	nəŋ²²	
嫩	嫩	nəŋ¹³	
寧	宁	nəŋ¹³	白讀，如：寧可
森	森	səŋ⁵¹	
參	参	səŋ⁵¹	人蔘
孫	孙	səŋ⁵¹	
僧	僧	səŋ⁵¹	
生	生	səŋ⁵¹	文讀
笙	笙	səŋ⁵¹	
損	损	səŋ³⁴	
滲	渗	səŋ⁴⁴	
遜	逊	səŋ⁴⁴	
層	层	zəŋ¹³	
跟	跟	kəŋ⁵¹	
根	根	kəŋ⁵¹	
更	更	kəŋ⁵¹	更換；文讀
耿	耿	kəŋ³⁴	文讀
更	更	kəŋ⁴⁴	更加
坑	坑	kʰəŋ⁵¹	文讀
懇	恳	kʰəŋ³⁴	
墾	垦	kʰəŋ³⁴	
啃	啃	kʰəŋ³⁴	
肯	肯	kʰəŋ³⁴	
艮	艮	ɡəŋ¹³	性情執拗
哼	哼	həŋ⁵¹	訓斥
很	很	həŋ³⁴	
浫	浫	həŋ⁴⁴	液體被吸收並滲透
洵	洵	həŋ⁴⁴	洵鼻涕
痕	痕	ɦəŋ²²	
恆	恒	ɦəŋ²²	
衡	衡	ɦəŋ²²	
恨	恨	ɦəŋ¹³	
恩	恩	əŋ⁵¹	
彬	彬	piŋ⁵¹	
賓	宾	piŋ⁵¹	
檳	槟	piŋ⁵¹	
冰	冰	piŋ⁵¹	
兵	兵	piŋ⁵¹	
稟	禀	piŋ³⁴	
丙	丙	piŋ³⁴	
秉	秉	piŋ³⁴	
餅	饼	piŋ³⁴	
併	并	piŋ³⁴	合併
殯	殡	piŋ⁴⁴	
鬢	鬓	piŋ⁴⁴	
柄	柄	piŋ⁴⁴	
拼	拼	pʰiŋ⁵¹	
姘	姘	pʰiŋ⁵¹	
品	品	pʰiŋ³⁴	
聘	聘	pʰiŋ⁴⁴	
貧	贫	biŋ²²	
頻	频	biŋ²²	
憑	凭	biŋ²²	
平	平	biŋ²²	
坪	坪	biŋ²²	
評	评	biŋ²²	
瓶	瓶	biŋ²²	
屏	屏	biŋ²²	
萍	萍	biŋ²²	
病	病	biŋ¹³	
並	并	biŋ¹³	並列
閩	闽	miŋ²²	
民	民	miŋ²²	
鳴	鸣	miŋ²²	
明	明	miŋ²²	
名	名	miŋ²²	
銘	铭	miŋ²²	
憫	悯	miŋ¹³	
敏	敏	miŋ¹³	
抿	抿	miŋ¹³	
皿	皿	miŋ¹³	
命	命	miŋ¹³	
丁	丁	tiŋ⁵¹	
釘	钉	tiŋ⁵¹	鐵釘
靪	靪	tiŋ⁵¹	
疔	疔	tiŋ⁵¹	
頂	顶	tiŋ³⁴	文讀
鼎	鼎	tiŋ³⁴	
釘	钉	tiŋ⁴⁴	釘住
訂	订	tiŋ⁴⁴	
廳	厅	tʰiŋ⁵¹	
汀	汀	tʰiŋ⁵¹	
艇	艇	tʰiŋ³⁴	
挺	挺	tʰiŋ³⁴	
聽	听	tʰiŋ⁴⁴	
亭	亭	diŋ²²	
停	停	diŋ²²	文讀
廷	廷	diŋ²²	
庭	庭	diŋ²²	
蜓	蜓	diŋ²²	蜻蜓
錠	锭	diŋ¹³	
定	定	diŋ¹³	
拎	拎	ʔliŋ⁵¹	
林	林	liŋ²²	
淋	淋	liŋ²²	
臨	临	liŋ²²	
鄰	邻	liŋ²²	
鱗	鳞	liŋ²²	
磷	磷	liŋ²²	
陵	陵	liŋ²²	
凌	凌	liŋ²²	
菱	菱	liŋ²²	
靈	灵	liŋ²²	
零	零	liŋ²²	
鈴	铃	liŋ²²	
伶	伶	liŋ²²	
翎	翎	liŋ²²	
賃	赁	liŋ¹³	
吝	吝	liŋ¹³	
領	领	liŋ¹³	
嶺	岭	liŋ¹³	
令	令	liŋ¹³	
另	另	liŋ¹³	
針	针	tɕiŋ⁵¹	
斟	斟	tɕiŋ⁵¹	
今	今	tɕiŋ⁵¹	
金	金	tɕiŋ⁵¹	
禁	禁	tɕiŋ⁵¹	禁不住
襟	襟	tɕiŋ⁵¹	
津	津	tɕiŋ⁵¹	
巾	巾	tɕiŋ⁵¹	
斤	斤	tɕiŋ⁵¹	
筋	筋	tɕiŋ⁵¹	
徵	征	tɕiŋ⁵¹	
蒸	蒸	tɕiŋ⁵¹	
莖	茎	tɕiŋ⁵¹	
京	京	tɕiŋ⁵¹	
荊	荆	tɕiŋ⁵¹	
驚	惊	tɕiŋ⁵¹	
精	精	tɕiŋ⁵¹	
晶	晶	tɕiŋ⁵¹	
睛	睛	tɕiŋ⁵¹	
貞	贞	tɕiŋ⁵¹	
偵	侦	tɕiŋ⁵¹	
正	正	tɕiŋ⁵¹	正月
征	征	tɕiŋ⁵¹	
經	经	tɕiŋ⁵¹	
枕	枕	tɕiŋ³⁴	
錦	锦	tɕiŋ³⁴	
緊	紧	tɕiŋ³⁴	
謹	谨	tɕiŋ³⁴	
拯	拯	tɕiŋ³⁴	
境	境	tɕiŋ³⁴	
景	景	tɕiŋ³⁴	
警	警	tɕiŋ³⁴	
井	井	tɕiŋ³⁴	
整	整	tɕiŋ³⁴	
頸	颈	tɕiŋ³⁴	
浸	浸	tɕiŋ⁴⁴	
禁	禁	tɕiŋ⁴⁴	禁止
進	进	tɕiŋ⁴⁴	
晉	晋	tɕiŋ⁴⁴	
勁	劲	tɕiŋ⁴⁴	
證	证	tɕiŋ⁴⁴	
症	症	tɕiŋ⁴⁴	
鯽	鲫	tɕiŋ⁴⁴	又音
敬	敬	tɕiŋ⁴⁴	
竟	竟	tɕiŋ⁴⁴	
鏡	镜	tɕiŋ⁴⁴	
正	正	tɕiŋ⁴⁴	
政	政	tɕiŋ⁴⁴	
勁	劲	tɕiŋ⁴⁴	勁敵
徑	径	tɕiŋ⁴⁴	
經	经	tɕiŋ⁴⁴	經緯
欽	钦	tɕʰiŋ⁵¹	
親	亲	tɕʰiŋ⁵¹	
稱	称	tɕʰiŋ⁵¹	
卿	卿	tɕʰiŋ⁵¹	
清	清	tɕʰiŋ⁵¹	
蟶	蛏	tɕʰiŋ⁵¹	蟶子
輕	轻	tɕʰiŋ⁵¹	
青	青	tɕʰiŋ⁵¹	
蜻	蜻	tɕʰiŋ⁵¹	蜻蜓
傾	倾	tɕʰiŋ⁵¹	
寢	寝	tɕʰiŋ³⁴	
請	请	tɕʰiŋ³⁴	
逞	逞	tɕʰiŋ³⁴	逞能
頃	顷	tɕʰiŋ³⁴	
侵	侵	tɕʰiŋ⁴⁴	
撳	揿	tɕʰiŋ⁴⁴	按
趁	趁	tɕʰiŋ⁴⁴	
秤	秤	tɕʰiŋ⁴⁴	
慶	庆	tɕʰiŋ⁴⁴	
磬	磬	tɕʰiŋ⁴⁴	
沉	沉	dʑiŋ²²	
琴	琴	dʑiŋ²²	
禽	禽	dʑiŋ²²	
擒	擒	dʑiŋ²²	
秦	秦	dʑiŋ²²	
陳	陈	dʑiŋ²²	
塵	尘	dʑiŋ²²	
臣	臣	dʑiŋ²²	
勤	勤	dʑiŋ²²	
芹	芹	dʑiŋ²²	
澄	澄	dʑiŋ²²	
懲	惩	dʑiŋ²²	
橙	橙	dʑiŋ²²	
乘	乘	dʑiŋ²²	
承	承	dʑiŋ²²	
丞	丞	dʑiŋ²²	
擎	擎	dʑiŋ²²	
鯨	鲸	dʑiŋ²²	
情	情	dʑiŋ²²	
晴	晴	dʑiŋ²²	
呈	呈	dʑiŋ²²	
程	程	dʑiŋ²²	
成	成	dʑiŋ²²	
城	城	dʑiŋ²²	
誠	诚	dʑiŋ²²	
盡	尽	dʑiŋ¹³	
陣	阵	dʑiŋ¹³	
僅	仅	dʑiŋ¹³	
近	近	dʑiŋ¹³	
剩	剩	dʑiŋ¹³	
競	竞	dʑiŋ¹³	
靖	靖	dʑiŋ¹³	
鄭	郑	dʑiŋ¹³	
勁	劲	dʑiŋ¹³	勁道：力氣
壬	壬	ȵiŋ²²	
任	任	ȵiŋ²²	姓
吟	吟	ȵiŋ²²	
人	人	ȵiŋ²²	白讀
銀	银	ȵiŋ²²	
仍	仍	ȵiŋ²²	
凝	凝	ȵiŋ²²	
迎	迎	ȵiŋ²²	
認	认	ȵiŋ¹³	白讀
寧	宁	ȵiŋ¹³	白讀
佞	佞	ȵiŋ¹³	
心	心	ɕiŋ⁵¹	
深	深	ɕiŋ⁵¹	
辛	辛	ɕiŋ⁵¹	
新	新	ɕiŋ⁵¹	
薪	薪	ɕiŋ⁵¹	
伸	伸	ɕiŋ⁵¹	
欣	欣	ɕiŋ⁵¹	
升	升	ɕiŋ⁵¹	
聲	声	ɕiŋ⁵¹	
星	星	ɕiŋ⁵¹	
腥	腥	ɕiŋ⁵¹	
馨	馨	ɕiŋ⁵¹	
沈	沈	ɕiŋ³⁴	
審	审	ɕiŋ³⁴	
嬸	婶	ɕiŋ³⁴	
省	省	ɕiŋ³⁴	反省
醒	醒	ɕiŋ³⁴	
信	信	ɕiŋ⁴⁴	
訊	讯	ɕiŋ⁴⁴	
釁	衅	ɕiŋ⁴⁴	
迅	迅	ɕiŋ⁴⁴	
勝	胜	ɕiŋ⁴⁴	
興	兴	ɕiŋ⁴⁴	
性	性	ɕiŋ⁴⁴	
姓	姓	ɕiŋ⁴⁴	
聖	圣	ɕiŋ⁴⁴	
尋	寻	ʑiŋ²²	
繩	绳	ʑiŋ²²	
塍	塍	ʑiŋ²²	田塍
椹	椹	ʑiŋ¹³	桑椹
甚	甚	ʑiŋ¹³	
慎	慎	ʑiŋ¹³	
靜	静	ʑiŋ¹³	
淨	净	ʑiŋ¹³	文讀
盛	盛	ʑiŋ¹³	
淫	淫	ɦiŋ²²	
寅	寅	ɦiŋ²²	
蠅	蝇	ɦiŋ²²	
盈	盈	ɦiŋ²²	
贏	赢	ɦiŋ²²	
形	形	ɦiŋ²²	
型	型	ɦiŋ²²	
刑	刑	ɦiŋ²²	
陘	陉	ɦiŋ²²	
螢	萤	ɦiŋ²²	文讀
滎	荥	ɦiŋ²²	滎陽
營	营	ɦiŋ²²	
塋	茔	ɦiŋ²²	
行	行	ɦiŋ²²	行爲，文讀
引	引	ɦiŋ¹³	
尹	尹	ɦiŋ¹³	
幸	幸	ɦiŋ¹³	
穎	颖	ɦiŋ¹³	
行	行	ɦiŋ¹³	品行，文讀
音	音	iŋ⁵¹	
陰	阴	iŋ⁵¹	
因	因	iŋ⁵¹	
姻	姻	iŋ⁵¹	
殷	殷	iŋ⁵¹	
鷹	鹰	iŋ⁵¹	
鶯	莺	iŋ⁵¹	文讀
鸚	鹦	iŋ⁵¹	鸚鵡
櫻	樱	iŋ⁵¹	文讀
英	英	iŋ⁵¹	
嬰	婴	iŋ⁵¹	
纓	缨	iŋ⁵¹	
飲	饮	iŋ³⁴	
隱	隐	iŋ³⁴	
影	影	iŋ³⁴	
蔭	荫	iŋ⁴⁴	
印	印	iŋ⁴⁴	
熨	熨	iŋ⁴⁴	
應	应	iŋ⁴⁴	
映	映	iŋ⁴⁴	
滾	滚	kuəŋ³⁴	
棍	棍	kuəŋ⁴⁴	
昆	昆	kʰuəŋ⁵¹	
坤	坤	kʰuəŋ⁵¹	
捆	捆	kʰuəŋ³⁴	
困	困	kʰuəŋ⁴⁴	
睏	睏	kʰuəŋ⁴⁴	睡覺
昏	昏	huəŋ⁵¹	
婚	婚	huəŋ⁵¹	
葷	荤	huəŋ⁵¹	
魂	魂	ɦuəŋ²²	
餛	馄	ɦuəŋ²²	餛飩
渾	浑	ɦuəŋ²²	
混	混	ɦuəŋ¹³	
溫	温	uəŋ⁵¹	
瘟	瘟	uəŋ⁵¹	
穩	稳	uəŋ³⁴	
搵	搵	uəŋ⁴⁴	蘸
崩	崩	poŋ⁵¹	又音
捧	捧	pʰoŋ³⁴	
碰	碰	pʰoŋ⁴⁴	文讀
篷	篷	boŋ²²	
蓬	蓬	boŋ²²	
蒙	蒙	moŋ²²	
夢	梦	moŋ²²	文讀
懵	懵	moŋ¹³	
風	风	foŋ⁵¹	
楓	枫	foŋ⁵¹	
瘋	疯	foŋ⁵¹	
丰	丰	foŋ⁵¹	
豐	丰	foŋ⁵¹	
封	封	foŋ⁵¹	
峯	峰	foŋ⁵¹	
峰	峰	foŋ⁵¹	
蜂	蜂	foŋ⁵¹	
鋒	锋	foŋ⁵¹	
諷	讽	foŋ³⁴	
瘋	疯	foŋ⁴⁴	縱情嬉鬧
馮	冯	voŋ²²	
逢	逢	voŋ²²	
縫	缝	voŋ²²	縫衣服
鳳	凤	voŋ¹³	
奉	奉	voŋ¹³	
俸	俸	voŋ¹³	
縫	缝	voŋ¹³	一條縫
東	东	toŋ⁵¹	
冬	冬	toŋ⁵¹	
董	董	toŋ³⁴	
懂	懂	toŋ³⁴	
凍	冻	toŋ⁴⁴	
棟	栋	toŋ⁴⁴	
通	通	tʰoŋ⁵¹	
捅	捅	tʰoŋ³⁴	
統	统	tʰoŋ³⁴	
痛	痛	tʰoŋ⁴⁴	
同	同	doŋ²²	
銅	铜	doŋ²²	
桐	桐	doŋ²²	
筒	筒	doŋ²²	
童	童	doŋ²²	
瞳	瞳	doŋ²²	
桶	桶	doŋ¹³	
動	动	doŋ¹³	
洞	洞	doŋ¹³	
籠	笼	loŋ²²	
聾	聋	loŋ²²	
隆	隆	loŋ²²	
龍	龙	loŋ²²	
攏	拢	loŋ¹³	
弄	弄	loŋ¹³	
隴	陇	loŋ¹³	
壟	垄	loŋ¹³	
六	六	loŋ¹³	兒化音，如：十五六
珍	珍	tsoŋ⁵¹	
真	真	tsoŋ⁵¹	
肫	肫	tsoŋ⁵¹	肫肝
棕	棕	tsoŋ⁵¹	
鬃	鬃	tsoŋ⁵¹	
宗	宗	tsoŋ⁵¹	
中	中	tsoŋ⁵¹	當中
終	终	tsoŋ⁵¹	
蹤	踪	tsoŋ⁵¹	
鍾	钟	tsoŋ⁵¹	
鐘	钟	tsoŋ⁵¹	
盅	盅	tsoŋ⁵¹	
供	供	tsoŋ⁵¹	白讀，舊
診	诊	tsoŋ³⁴	
疹	疹	tsoŋ³⁴	
準	准	tsoŋ³⁴	
總	总	tsoŋ³⁴	
冢	冢	tsoŋ³⁴	
種	种	tsoŋ³⁴	種類
腫	肿	tsoŋ³⁴	
鎮	镇	tsoŋ⁴⁴	
振	振	tsoŋ⁴⁴	
震	震	tsoŋ⁴⁴	
俊	俊	tsoŋ⁴⁴	
糉	粽	tsoŋ⁴⁴	
粽	粽	tsoŋ⁴⁴	
中	中	tsoŋ⁴⁴	中獎
衆	众	tsoŋ⁴⁴	
眾	众	tsoŋ⁴⁴	
縱	纵	tsoŋ⁴⁴	
種	种	tsoŋ⁴⁴	種樹
皴	皴	tsʰoŋ⁵¹	臉皴
椿	椿	tsʰoŋ⁵¹	
春	春	tsʰoŋ⁵¹	
聰	聪	tsʰoŋ⁵¹	
匆	匆	tsʰoŋ⁵¹	
蔥	葱	tsʰoŋ⁵¹	
囪	囱	tsʰoŋ⁵¹	
充	充	tsʰoŋ⁵¹	
從	从	tsʰoŋ⁵¹	
衝	冲	tsʰoŋ⁵¹	
舂	舂	tsʰoŋ⁵¹	
蠢	蠢	tsʰoŋ³⁴	
寵	宠	tsʰoŋ³⁴	
蹱	蹱	tsʰoŋ⁴⁴	走路不穩
銃	铳	tsʰoŋ⁴⁴	放銃
叢	丛	dzoŋ²²	
蟲	虫	dzoŋ²²	
崇	崇	dzoŋ²²	
從	从	dzoŋ²²	跟從
重	重	dzoŋ²²	
仲	仲	dzoŋ¹³	
齈	齈	ʔnoŋ⁴⁴	多涕鼻疾
膿	脓	noŋ²²	
農	农	noŋ²²	
儂	侬	noŋ²²	
身	身	soŋ⁵¹	
申	申	soŋ⁵¹	
娠	娠	soŋ⁵¹	
荀	荀	soŋ⁵¹	
旬	旬	soŋ⁵¹	
松	松	soŋ⁵¹	
嵩	嵩	soŋ⁵¹	
鬆	松	soŋ⁵¹	
筍	笋	soŋ³⁴	
榫	榫	soŋ³⁴	榫頭
慫	怂	soŋ³⁴	
殉	殉	soŋ⁴⁴	
舜	舜	soŋ⁴⁴	
送	送	soŋ⁴⁴	
宋	宋	soŋ⁴⁴	
叔	叔	soŋ⁴⁴	兒化音
神	神	zoŋ²²	
辰	辰	zoŋ²²	
晨	晨	zoŋ²²	
腎	肾	zoŋ²²	
人	人	zoŋ²²	文讀
仁	仁	zoŋ²²	
循	循	zoŋ²²	
巡	巡	zoŋ²²	
脣	唇	zoŋ²²	
純	纯	zoŋ²²	
蓴	莼	zoŋ²²	
任	任	zoŋ¹³	責任
紉	纫	zoŋ¹³	縫紉
慎	慎	zoŋ¹³	又音
忍	忍	zoŋ¹³	
刃	刃	zoŋ¹³	
認	认	zoŋ¹³	文讀
韌	韧	zoŋ¹³	
順	顺	zoŋ¹³	
醇	醇	zoŋ¹³	
潤	润	zoŋ¹³	
誦	诵	zoŋ¹³	
頌	颂	zoŋ¹³	
訟	讼	zoŋ¹³	
公	公	koŋ⁵¹	
蚣	蚣	koŋ⁵¹	蜈蚣
工	工	koŋ⁵¹	
功	功	koŋ⁵¹	
弓	弓	koŋ⁵¹	
躬	躬	koŋ⁵¹	
宮	宫	koŋ⁵¹	
恭	恭	koŋ⁵¹	
拱	拱	koŋ³⁴	
鞏	巩	koŋ³⁴	
攻	攻	koŋ⁴⁴	
貢	贡	koŋ⁴⁴	
汞	汞	koŋ⁴⁴	
供	供	koŋ⁴⁴	文讀
空	空	kʰoŋ⁵¹	空箱子
孔	孔	kʰoŋ³⁴	
恐	恐	kʰoŋ³⁴	
控	控	kʰoŋ⁴⁴	
空	空	kʰoŋ⁴⁴	空餘
共	共	ɡoŋ¹³	
轟	轰	hoŋ⁵¹	轟出去
烘	烘	hoŋ⁵¹	
哄	哄	hoŋ³⁴	
轟	轰	hoŋ⁴⁴	轟炸
弘	弘	ɦoŋ²²	
宏	宏	ɦoŋ²²	
紅	红	ɦoŋ²²	
洪	洪	ɦoŋ²²	
鴻	鸿	ɦoŋ²²	
虹	虹	ɦoŋ²²	
哄	哄	ɦoŋ¹³	起鬨
翁	翁	oŋ⁵¹	
屋	屋	oŋ⁵¹	兒化；五角屋兒：一種傳統小房子
蓊	蓊	oŋ³⁴	
甕	甕	oŋ⁴⁴	
蕹	蕹	oŋ⁴⁴	蕹菜
均	均	tɕyoŋ⁵¹	
鈞	钧	tɕyoŋ⁵¹	
君	君	tɕyoŋ⁵¹	
軍	军	tɕyoŋ⁵¹	
迥	迥	tɕyoŋ³⁴	
菌	菌	tɕʰyoŋ⁴⁴	
羣	群	dʑyoŋ²²	
裙	裙	dʑyoŋ²²	
瓊	琼	dʑyoŋ²²	
窮	穷	dʑyoŋ²²	
窘	窘	dʑyoŋ¹³	
郡	郡	dʑyoŋ¹³	
戎	戎	ȵyoŋ²²	
絨	绒	ȵyoŋ²²	
濃	浓	ȵyoŋ²²	
薰	熏	ɕyoŋ⁵¹	
勳	勋	ɕyoŋ⁵¹	
薰	薰	ɕyoŋ⁵¹	
兄	兄	ɕyoŋ⁵¹	
胸	胸	ɕyoŋ⁵¹	
兇	凶	ɕyoŋ⁵¹	
凶	凶	ɕyoŋ⁵¹	
訓	训	ɕyoŋ⁴⁴	
嗅	嗅	ɕyoŋ⁴⁴	用鼻子聞
勻	匀	ɦyoŋ²²	
云	云	ɦyoŋ²²	
雲	云	ɦyoŋ²²	
螢	萤	ɦyoŋ²²	白讀；火螢頭：螢火蟲
榮	荣	ɦyoŋ²²	
熊	熊	ɦyoŋ²²	
雄	雄	ɦyoŋ²²	
融	融	ɦyoŋ²²	
茸	茸	ɦyoŋ²²	蔘茸
冗	冗	ɦyoŋ²²	
容	容	ɦyoŋ²²	
蓉	蓉	ɦyoŋ²²	芙蓉
熔	熔	ɦyoŋ²²	
庸	庸	ɦyoŋ²²	又音
閏	闰	ɦyoŋ¹³	
允	允	ɦyoŋ¹³	
韻	韵	ɦyoŋ¹³	
運	运	ɦyoŋ¹³	
暈	晕	ɦyoŋ¹³	
孕	孕	ɦyoŋ¹³	
詠	咏	ɦyoŋ¹³	
用	用	ɦyoŋ¹³	
雍	雍	yoŋ⁵¹	
臃	臃	yoŋ⁵¹	
庸	庸	yoŋ⁵¹	又音
永	永	yoŋ³⁴	
泳	泳	yoŋ³⁴	
詠	咏	yoŋ³⁴	又音
擁	拥	yoŋ³⁴	
甬	甬	yoŋ³⁴	
勇	勇	yoŋ³⁴	
涌	涌	yoŋ³⁴	
壅	壅	yoŋ⁴⁴	施肥
八	八	paʔ⁵	
鉢	钵	paʔ⁵	
撥	拨	paʔ⁵	
不	不	paʔ⁵	
百	百	paʔ⁵	
柏	柏	paʔ⁵	
伯	伯	paʔ⁵	
迫	迫	paʔ⁵	
蘗	蘗	paʔ⁵	黃蘗，藥名
潑	泼	pʰaʔ⁵	
泊	泊	pʰaʔ⁵	梁山泊
迫	迫	pʰaʔ⁵	又音
拍	拍	pʰaʔ⁵	
帕	帕	pʰaʔ⁵	
魄	魄	pʰaʔ⁵	
拔	拔	baʔ²³	
鈸	钹	baʔ²³	
白	白	baʔ²³	
帛	帛	baʔ²³	
鼻	鼻	baʔ²³	又音
抹	抹	maʔ²³	
末	末	maʔ²³	
沫	沫	maʔ²³	
抹	抹	maʔ²³	
襪	袜	maʔ²³	
沒	没	maʔ²³	
默	默	maʔ²³	
𢫦	𢫦	maʔ²³	打
陌	陌	maʔ²³	
麥	麦	maʔ²³	
脈	脉	maʔ²³	
法	法	faʔ⁵	
發	发	faʔ⁵	
佛	佛	faʔ⁵	彷彿
乏	乏	vaʔ²³	
伐	伐	vaʔ²³	
筏	筏	vaʔ²³	
罰	罚	vaʔ²³	
佛	佛	vaʔ²³	
物	物	vaʔ²³	
勿	勿	vaʔ²³	
答	答	taʔ⁵	
搭	搭	taʔ⁵	
掇	掇	taʔ⁵	兩手掇起
得	得	taʔ⁵	
德	德	taʔ⁵	
拓	拓	tʰaʔ⁵	拓本
塔	塔	tʰaʔ⁵	
榻	榻	tʰaʔ⁵	
塌	塌	tʰaʔ⁵	
溻	溻	tʰaʔ⁵	
獺	獭	tʰaʔ⁵	水獺
脫	脱	tʰaʔ⁵	
忒	忒	tʰaʔ⁵	忒好
踏	踏	daʔ²³	
沓	沓	daʔ²³	一沓紙
達	达	daʔ²³	
奪	夺	daʔ²³	
突	突	daʔ²³	
特	特	daʔ²³	
臘	腊	laʔ²³	
蠟	蜡	laʔ²³	
鑞	镴	laʔ²³	錫鑞
獵	猎	laʔ²³	又音
辣	辣	laʔ²³	
瘌	瘌	laʔ²³	
捋	捋	laʔ²³	捋袖
肋	肋	laʔ²³	
勒	勒	laʔ²³	
扎	扎	tsaʔ⁵	
眨	眨	tsaʔ⁵	
札	札	tsaʔ⁵	
卒	卒	tsaʔ⁵	
則	则	tsaʔ⁵	
側	侧	tsaʔ⁵	
窄	窄	tsaʔ⁵	
摘	摘	tsaʔ⁵	
責	责	tsaʔ⁵	
柵	栅	tsaʔ⁵	
隻	只	tsaʔ⁵	一隻
插	插	tsʰaʔ⁵	
擦	擦	tsʰaʔ⁵	
察	察	tsʰaʔ⁵	
徹	彻	tsʰaʔ⁵	又音
撤	撤	tsʰaʔ⁵	
撮	撮	tsʰaʔ⁵	
黢	黢	tsʰaʔ⁵	黢黑
側	侧	tsʰaʔ⁵	又音
測	测	tsʰaʔ⁵	
拆	拆	tsʰaʔ⁵	
㿭	㿭	tsʰaʔ⁵	皴
策	策	tsʰaʔ⁵	
冊	册	tsʰaʔ⁵	
赤	赤	tsʰaʔ⁵	
斥	斥	tsʰaʔ⁵	
尺	尺	tsʰaʔ⁵	
轍	辙	dzaʔ²³	
澤	泽	dzaʔ²³	
擇	择	dzaʔ²³	
宅	宅	dzaʔ²³	
納	纳	naʔ²³	
捺	捺	naʔ²³	撇捺
澀	涩	saʔ⁵	
撒	撒	saʔ⁵	
薩	萨	saʔ⁵	
殺	杀	saʔ⁵	
瑟	瑟	saʔ⁵	
蝨	虱	saʔ⁵	
率	率	saʔ⁵	率領
蟀	蟀	saʔ⁵	
塞	塞	saʔ⁵	
色	色	saʔ⁵	
嗇	啬	saʔ⁵	
雜	杂	zaʔ²³	
閘	闸	zaʔ²³	
炸	炸	zaʔ²³	用油炸
鍘	铡	zaʔ²³	
賊	贼	zaʔ²³	
宅	宅	zaʔ²³	又音
石	石	zaʔ²³	
蛤	蛤	kaʔ⁵	隔離
鴿	鸽	kaʔ⁵	
夾	夹	kaʔ⁵	
甲	甲	kaʔ⁵	盔甲
胛	胛	kaʔ⁵	肩胛
割	割	kaʔ⁵	
葛	葛	kaʔ⁵	
胳	胳	kaʔ⁵	
格	格	kaʔ⁵	
革	革	kaʔ⁵	
隔	隔	kaʔ⁵	
磕	磕	kʰaʔ⁵	
掐	掐	kʰaʔ⁵	
渴	渴	kʰaʔ⁵	
刻	刻	kʰaʔ⁵	
克	克	kʰaʔ⁵	
客	客	kʰaʔ⁵	
茄	茄	ɡaʔ²³	番茄
軋	轧	ɡaʔ²³	
扤	扤	ʔŋaʔ⁵	搖動，晃動；如：頭扤扤
額	额	ŋaʔ²³	
嚇	吓	haʔ⁵	
喝	喝	haʔ⁵	
瞎	瞎	haʔ⁵	
黑	黑	haʔ⁵	
赫	赫	haʔ⁵	
合	合	ɦaʔ²³	
盒	盒	ɦaʔ²³	
狹	狭	ɦaʔ²³	
峽	峡	ɦaʔ²³	
洽	洽	ɦaʔ²³	
匣	匣	ɦaʔ²³	
轄	辖	ɦaʔ²³	
核	核	ɦaʔ²³	覈對，審覈
阿	阿	aʔ⁵	阿哥，又音
鴨	鸭	aʔ⁵	
押	押	aʔ⁵	
壓	压	aʔ⁵	
扼	扼	aʔ⁵	
軛	轭	aʔ⁵	
括	括	kuaʔ⁵	包括
刮	刮	kuaʔ⁵	
骨	骨	kuaʔ⁵	
闊	阔	kʰuaʔ⁵	
☐	☐	ɡuaʔ²³	（鳥類）揮動（翅膀）
豁	豁	huaʔ⁵	
忽	忽	huaʔ⁵	
活	活	ɦuaʔ²³	
滑	滑	ɦuaʔ²³	
猾	猾	ɦuaʔ²³	
𣝗	𣝗	ɦuaʔ²³	果核
劃	划	ɦuaʔ²³	
挖	挖	uaʔ⁵	
鱉	鳖	pieʔ⁵	
憋	憋	pieʔ⁵	
筆	笔	pieʔ⁵	
畢	毕	pieʔ⁵	
必	必	pieʔ⁵	
逼	逼	pieʔ⁵	
碧	碧	pieʔ⁵	
璧	璧	pieʔ⁵	
壁	壁	pieʔ⁵	
撇	撇	pʰieʔ⁵	
匹	匹	pʰieʔ⁵	
僻	僻	pʰieʔ⁵	
闢	辟	pʰieʔ⁵	
劈	劈	pʰieʔ⁵	
鼻	鼻	bieʔ²³	
別	别	bieʔ²³	
弼	弼	bieʔ²³	
滅	灭	mieʔ²³	
篾	篾	mieʔ²³	
密	密	mieʔ²³	
蜜	蜜	mieʔ²³	
覓	觅	mieʔ²³	
跌	跌	tieʔ⁵	
的	的	tieʔ⁵	目的
滴	滴	tieʔ⁵	
嫡	嫡	tieʔ⁵	
帖	帖	tʰieʔ⁵	
貼	贴	tʰieʔ⁵	
鐵	铁	tʰieʔ⁵	
踢	踢	tʰieʔ⁵	
剔	剔	tʰieʔ⁵	
疊	叠	dieʔ²³	
碟	碟	dieʔ²³	
牒	牒	dieʔ²³	
蝶	蝶	dieʔ²³	
諜	谍	dieʔ²³	
秩	秩	dieʔ²³	
笛	笛	dieʔ²³	
敵	敌	dieʔ²³	
狄	狄	dieʔ²³	
糴	籴	dieʔ²³	
獵	猎	lieʔ²³	
立	立	lieʔ²³	
笠	笠	lieʔ²³	
粒	粒	lieʔ²³	
列	列	lieʔ²³	
烈	烈	lieʔ²³	
裂	裂	lieʔ²³	
劣	劣	lieʔ²³	
栗	栗	lieʔ²³	
慄	栗	lieʔ²³	
律	律	lieʔ²³	
率	率	lieʔ²³	速率
略	略	lieʔ²³	
掠	掠	lieʔ²³	
力	力	lieʔ²³	
歷	历	lieʔ²³	
髻	髻	tɕieʔ⁵	又音
甲	甲	tɕieʔ⁵	甲乙丙丁
接	接	tɕieʔ⁵	
褶	褶	tɕieʔ⁵	褶子，皺紋
劫	劫	tɕieʔ⁵	
執	执	tɕieʔ⁵	
汁	汁	tɕieʔ⁵	
急	急	tɕieʔ⁵	
級	级	tɕieʔ⁵	
給	给	tɕieʔ⁵	供給
揭	揭	tɕieʔ⁵	
節	节	tɕieʔ⁵	
結	结	tɕieʔ⁵	
潔	洁	tɕieʔ⁵	
吉	吉	tɕieʔ⁵	
訖	讫	tɕieʔ⁵	
爵	爵	tɕieʔ⁵	
腳	脚	tɕieʔ⁵	
即	即	tɕieʔ⁵	
鯽	鲫	tɕieʔ⁵	
織	织	tɕieʔ⁵	
職	职	tɕieʔ⁵	
戟	戟	tɕieʔ⁵	
積	积	tɕieʔ⁵	
跡	迹	tɕieʔ⁵	
脊	脊	tɕieʔ⁵	
只	只	tɕieʔ⁵	只有
績	绩	tɕieʔ⁵	
擊	击	tɕieʔ⁵	
激	激	tɕieʔ⁵	
恰	恰	tɕʰieʔ⁵	
妾	妾	tɕʰieʔ⁵	
怯	怯	tɕʰieʔ⁵	
泣	泣	tɕʰieʔ⁵	
徹	彻	tɕʰieʔ⁵	
切	切	tɕʰieʔ⁵	
七	七	tɕʰieʔ⁵	
漆	漆	tɕʰieʔ⁵	
乞	乞	tɕʰieʔ⁵	
雀	雀	tɕʰieʔ⁵	雀鳥
鵲	鹊	tɕʰieʔ⁵	喜鵲
卻	却	tɕʰieʔ⁵	
飭	饬	tɕʰieʔ⁵	
赤	赤	tɕʰieʔ⁵	又音
戚	戚	tɕʰieʔ⁵	
藉	藉	dʑieʔ²³	藉故
捷	捷	dʑieʔ²³	
涉	涉	dʑieʔ²³	
集	集	dʑieʔ²³	
輯	辑	dʑieʔ²³	
蟄	蛰	dʑieʔ²³	驚蟄
及	及	dʑieʔ²³	
傑	杰	dʑieʔ²³	
截	截	dʑieʔ²³	
疾	疾	dʑieʔ²³	
侄	侄	dʑieʔ²³	
姪	侄	dʑieʔ²³	
直	直	dʑieʔ²³	
值	值	dʑieʔ²³	
殖	殖	dʑieʔ²³	
植	植	dʑieʔ²³	
極	极	dʑieʔ²³	
劇	剧	dʑieʔ²³	
屐	屐	dʑieʔ²³	木屐
籍	籍	dʑieʔ²³	
藉	藉	dʑieʔ²³	
擲	掷	dʑieʔ²³	
寂	寂	dʑieʔ²³	
聶	聂	ȵieʔ²³	
鑷	镊	ȵieʔ²³	
躡	蹑	ȵieʔ²³	
業	业	ȵieʔ²³	
苶	苶	ȵieʔ²³	發苶
熱	热	ȵieʔ²³	
孽	孽	ȵieʔ²³	
捏	捏	ȵieʔ²³	
日	日	ȵieʔ²³	白讀
虐	虐	ȵieʔ²³	
瘧	疟	ȵieʔ²³	瘧疾，發瘧子
匿	匿	ȵieʔ²³	
逆	逆	ȵieʔ²³	
溺	溺	ȵieʔ²³	
些	些	ɕieʔ⁵	
攝	摄	ɕieʔ⁵	
脅	胁	ɕieʔ⁵	
溼	湿	ɕieʔ⁵	
吸	吸	ɕieʔ⁵	
薛	薛	ɕieʔ⁵	
泄	泄	ɕieʔ⁵	
歇	歇	ɕieʔ⁵	
蠍	蝎	ɕieʔ⁵	
屑	屑	ɕieʔ⁵	
楔	楔	ɕieʔ⁵	
悉	悉	ɕieʔ⁵	
膝	膝	ɕieʔ⁵	
削	削	ɕieʔ⁵	
識	识	ɕieʔ⁵	
式	式	ɕieʔ⁵	
飾	饰	ɕieʔ⁵	
惜	惜	ɕieʔ⁵	
昔	昔	ɕieʔ⁵	
適	适	ɕieʔ⁵	
釋	释	ɕieʔ⁵	
錫	锡	ɕieʔ⁵	
析	析	ɕieʔ⁵	
席	席	ʑieʔ²³	席子
攜	携	ʑieʔ²³	
協	协	ʑieʔ²³	
習	习	ʑieʔ²³	
襲	袭	ʑieʔ²³	
拾	拾	ʑieʔ²³	拾起來
舌	舌	ʑieʔ²³	
嚼	嚼	ʑieʔ²³	
芍	芍	ʑieʔ²³	芍藥花
弱	弱	ʑieʔ²³	
食	食	ʑieʔ²³	
蝕	蚀	ʑieʔ²³	
席	席	ʑieʔ²³	
夕	夕	ʑieʔ²³	
射	射	ʑieʔ²³	
該	该	kieʔ⁵	定指：這，那
該	该	kʰieʔ⁵	定指：這，那；又音
諧	谐	ɦieʔ²³	又音
械	械	ɦieʔ²³	又音
峽	峡	ɦieʔ²³	又音
葉	叶	ɦieʔ²³	
頁	页	ɦieʔ²³	
逸	逸	ɦieʔ²³	
藥	药	ɦieʔ²³	
鑰	钥	ɦieʔ²³	鑰匙
躍	跃	ɦieʔ²³	
翼	翼	ɦieʔ²³	
亦	亦	ɦieʔ²³	
譯	译	ɦieʔ²³	
易	易	ɦieʔ²³	交易
液	液	ɦieʔ²³	
腋	腋	ɦieʔ²³	
揖	揖	ieʔ⁵	作揖
噎	噎	ieʔ⁵	
乙	乙	ieʔ⁵	
一	一	ieʔ⁵	
約	约	ieʔ⁵	
抑	抑	ieʔ⁵	
益	益	ieʔ⁵	
博	博	poʔ⁵	
剝	剥	poʔ⁵	
駁	驳	poʔ⁵	
北	北	poʔ⁵	
卜	卜	poʔ⁵	
樸	朴	pʰoʔ⁵	
撲	扑	pʰoʔ⁵	
醭	醭	pʰoʔ⁵	白醭
博	博	boʔ²³	
泊	泊	boʔ²³	
縛	缚	boʔ²³	白讀
雹	雹	boʔ²³	
僕	仆	boʔ²³	
曝	曝	boʔ²³	
瀑	瀑	boʔ²³	
莫	莫	moʔ²³	
膜	膜	moʔ²³	
幕	幕	moʔ²³	
寞	寞	moʔ²³	
摸	摸	moʔ²³	
墨	墨	moʔ²³	
陌	陌	moʔ²³	又音
木	木	moʔ²³	
目	目	moʔ²³	
穆	穆	moʔ²³	
牧	牧	moʔ²³	
復	复	foʔ⁵	復興
福	福	foʔ⁵	
幅	幅	foʔ⁵	
蝠	蝠	foʔ⁵	蝙蝠
複	复	foʔ⁵	重複
腹	腹	foʔ⁵	
覆	覆	foʔ⁵	
復	复	foʔ⁵	復原；又音
縛	缚	voʔ²³	文讀
服	服	voʔ²³	
伏	伏	voʔ²³	
復	复	voʔ²³	復原
篤	笃	toʔ⁵	
督	督	toʔ⁵	
託	托	tʰoʔ⁵	
禿	秃	tʰoʔ⁵	
鐸	铎	doʔ²³	
踱	踱	doʔ²³	
獨	独	doʔ²³	
讀	读	doʔ²³	
牘	牍	doʔ²³	
犢	犊	doʔ²³	
毒	毒	doʔ²³	
摝	摝	ʔloʔ⁵	振動，搖動
睩	睩	ʔloʔ⁵	眼珠轉動
落	落	loʔ²³	
烙	烙	loʔ²³	
駱	骆	loʔ²³	
酪	酪	loʔ²³	
洛	洛	loʔ²³	
絡	络	loʔ²³	
樂	乐	loʔ²³	快樂
鹿	鹿	loʔ²³	
祿	禄	loʔ²³	
六	六	loʔ²³	
陸	陆	loʔ²³	
綠	绿	loʔ²³	
錄	录	loʔ²³	
蜘	蜘	tsoʔ⁵	蜘蛛，又音
折	折	tsoʔ⁵	
哲	哲	tsoʔ⁵	
浙	浙	tsoʔ⁵	
拙	拙	tsoʔ⁵	
質	质	tsoʔ⁵	
作	作	tsoʔ⁵	
酌	酌	tsoʔ⁵	
桌	桌	tsoʔ⁵	
卓	卓	tsoʔ⁵	
琢	琢	tsoʔ⁵	
啄	啄	tsoʔ⁵	
涿	涿	tsoʔ⁵	
捉	捉	tsoʔ⁵	
竹	竹	tsoʔ⁵	
築	筑	tsoʔ⁵	
筑	筑	tsoʔ⁵	
祝	祝	tsoʔ⁵	
粥	粥	tsoʔ⁵	
足	足	tsoʔ⁵	
燭	烛	tsoʔ⁵	
囑	嘱	tsoʔ⁵	
猝	猝	tsʰoʔ⁵	
黢	黢	tsʰoʔ⁵	黑黢黢
出	出	tsʰoʔ⁵	
綽	绰	tsʰoʔ⁵	
戳	戳	tsʰoʔ⁵	
畜	畜	tsʰoʔ⁵	畜牲
促	促	tsʰoʔ⁵	
觸	触	tsʰoʔ⁵	
絕	绝	dzoʔ²³	
朮	朮	dzoʔ²³	藥名：白朮，蒼朮
鑿	凿	dzoʔ²³	
着	着	dzoʔ²³	附着
濁	浊	dzoʔ²³	
鐲	镯	dzoʔ²³	
族	族	dzoʔ²³	
逐	逐	dzoʔ²³	
蜀	蜀	dzoʔ²³	
屬	属	dzoʔ²³	
諾	诺	noʔ²³	
設	设	soʔ⁵	
刷	刷	soʔ⁵	
雪	雪	soʔ⁵	
說	说	soʔ⁵	
失	失	soʔ⁵	
室	室	soʔ⁵	
戌	戌	soʔ⁵	
秫	秫	soʔ⁵	高粱
索	索	soʔ⁵	
朔	朔	soʔ⁵	
式	式	soʔ⁵	又音
速	速	soʔ⁵	
肅	肃	soʔ⁵	
宿	宿	soʔ⁵	
縮	缩	soʔ⁵	
叔	叔	soʔ⁵	
粟	粟	soʔ⁵	
束	束	soʔ⁵	
續	续	zoʔ²³	
十	十	zoʔ²³	
什	什	zoʔ²³	什物
入	入	zoʔ²³	
實	实	zoʔ²³	
日	日	zoʔ²³	文讀
術	术	zoʔ²³	
述	述	zoʔ²³	
昨	昨	zoʔ²³	
勺	勺	zoʔ²³	
若	若	zoʔ²³	
熟	熟	zoʔ²³	
淑	淑	zoʔ²³	
俗	俗	zoʔ²³	
續	续	zoʔ²³	
贖	赎	zoʔ²³	
辱	辱	zoʔ²³	
褥	褥	zoʔ²³	
各	各	koʔ⁵	
閣	阁	koʔ⁵	
擱	搁	koʔ⁵	
郭	郭	koʔ⁵	
覺	觉	koʔ⁵	知覺；白讀
角	角	koʔ⁵	
國	国	koʔ⁵	
虢	虢	koʔ⁵	
谷	谷	koʔ⁵	
窟	窟	kʰoʔ⁵	
廓	廓	kʰoʔ⁵	
擴	扩	kʰoʔ⁵	
確	确	kʰoʔ⁵	白讀
殼	壳	kʰoʔ⁵	
哭	哭	kʰoʔ⁵	
酷	酷	kʰoʔ⁵	
擱	搁	ɡoʔ²³	
鄂	鄂	ŋoʔ²³	
鶴	鹤	ŋoʔ²³	
嶽	岳	ŋoʔ²³	
郝	郝	hoʔ⁵	姓
霍	霍	hoʔ⁵	
藿	藿	hoʔ⁵	
鑊	镬	ɦoʔ²³	鍋
學	学	ɦoʔ²³	
或	或	ɦoʔ²³	
惑	惑	ɦoʔ²³	
獲	获	ɦoʔ²³	
惡	恶	oʔ⁵	善惡
握	握	oʔ⁵	
屋	屋	oʔ⁵	
沃	沃	oʔ⁵	
厥	厥	tɕyoʔ⁵	
決	决	tɕyoʔ⁵	
訣	诀	tɕyoʔ⁵	
橘	橘	tɕyoʔ⁵	
覺	觉	tɕyoʔ⁵	知覺；文讀
菊	菊	tɕyoʔ⁵	
缺	缺	tɕʰyoʔ⁵	
屈	屈	tɕʰyoʔ⁵	
確	确	tɕʰyoʔ⁵	文讀
喫	吃	tɕʰyoʔ⁵	
曲	曲	tɕʰyoʔ⁵	
榷	榷	tɕʰyoʔ⁵	
掘	掘	dʑyoʔ²³	
倔	倔	dʑyoʔ²³	
軸	轴	dʑyoʔ²³	
局	局	dʑyoʔ²³	
肉	肉	ȵyoʔ²³	
玉	玉	ȵyoʔ²³	
血	血	ɕyoʔ⁵	
恤	恤	ɕyoʔ⁵	
畜	畜	ɕyoʔ⁵	畜牧
蓄	蓄	ɕyoʔ⁵	儲蓄
悅	悦	ɦyoʔ²³	
閱	阅	ɦyoʔ²³	
月	月	ɦyoʔ²³	
越	越	ɦyoʔ²³	
曰	曰	ɦyoʔ²³	
粵	粤	ɦyoʔ²³	
穴	穴	ɦyoʔ²³	
樂	乐	ɦyoʔ²³	音樂；又音，新
域	域	ɦyoʔ²³	
疫	疫	ɦyoʔ²³	
役	役	ɦyoʔ²³	
育	育	ɦyoʔ²³	
獄	狱	ɦyoʔ²³	
欲	欲	ɦyoʔ²³	
浴	浴	ɦyoʔ²³	
噦	哕	yoʔ⁵	嘔吐
鬱	郁	yoʔ⁵	
姆	姆	ʔm̩⁴⁴	姆媽
姆	姆	m̩²²	阿姆
畝	亩	m̩¹³	白讀
母	母	m̩¹³	白讀
嘸	呒	ʔn̩⁴⁴	嘸納：沒有
爾	尔	ŋ̍¹³	你，白讀
芋	芋	ŋ̍¹³	芋艿
吳	吴	ŋ̍²²	白讀
魚	鱼	ŋ̍²²	
兒	儿	ŋ̍²²	白讀
五	五	ŋ̍¹³	
伍	伍	ŋ̍¹³	白讀
耳	耳	ŋ̍¹³	白讀
戊	戊	ŋ̍¹³	
兒	儿	l̩²²	文讀
而	而	l̩²²	
爾	尔	l̩¹³	文讀
二	二	l̩¹³	文讀
貳	贰	l̩¹³	文讀
耳	耳	l̩¹³	文讀
餌	饵	l̩¹³	
