繁體	简体	吳拼	備注
之	之	tsɿ⁵³	
資	资	tsɿ⁵³	
姿	姿	tsɿ⁵³	
咨	咨	tsɿ⁵³	
諮	咨	tsɿ⁵³	
滓	滓	tsɿ⁵³	
滋	滋	tsɿ⁵³	
輜	辎	tsɿ⁵³	
支	支	tsɿ⁵³	
枝	枝	tsɿ⁵³	
肢	肢	tsɿ⁵³	
梔	栀	tsɿ⁵³	
芝	芝	tsɿ⁵³	
鼠	鼠	tsɿ⁵³	白讀
齒	齿	tsɿ⁵³	白讀
紫	紫	tsɿ³⁵	
指	指	tsɿ³⁵	
紙	纸	tsɿ³⁵	
子	子	tsɿ³⁵	
梓	梓	tsɿ³⁵	
止	止	tsɿ³⁵	
趾	趾	tsɿ³⁵	
址	址	tsɿ³⁵	
旨	旨	tsɿ³⁵	
脂	脂	tsɿ³⁵	
至	至	tsɿ³⁵	
煮	煮	tsɿ³⁵	
只	只	tsɿ³⁵	文讀 只有
志	志	tsɿ³⁵	縣志
誌	志	tsɿ³⁵	縣誌
摯	挚	tsɿ⁴⁴	
幟	帜	tsɿ⁴⁴	
痣	痣	tsɿ⁴⁴	
志	志	tsɿ⁴⁴	志向
此	此	tsʰɿ⁵³	
雌	雌	tsʰɿ⁵³	
齒	齿	tsʰɿ⁵³	文讀
翅	翅	tsʰɿ³⁵	
刺	刺	tsʰɿ⁴⁴	
次	次	tsʰɿ⁴⁴	
廁	厕	tsʰɿ⁴⁴	
差	差	tsʰɿ⁴⁴	參差
茲	兹	dzɿ²²¹	
慈	慈	dzɿ²²¹	
磁	磁	dzɿ²²¹	
辭	辞	dzɿ²²¹	
瓷	瓷	dzɿ²²¹	
詞	词	dzɿ²²¹	
嗣	嗣	dzɿ²²¹	
師	师	sɿ⁵³	
獅	狮	sɿ⁵³	
私	私	sɿ⁵³	
屍	尸	sɿ⁵³	
尸	尸	sɿ⁵³	
梳	梳	sɿ⁵³	
斯	斯	sɿ⁵³	
廝	厮	sɿ⁵³	
撕	撕	sɿ⁵³	
施	施	sɿ⁵³	
司	司	sɿ⁵³	
絲	丝	sɿ⁵³	
思	思	sɿ⁵³	
詩	诗	sɿ⁵³	
篩	筛	sɿ⁵³	
嘶	嘶	sɿ⁵³	
駛	驶	sɿ³⁵	
矢	矢	sɿ³⁵	
史	史	sɿ³⁵	
使	使	sɿ³⁵	
始	始	sɿ³⁵	
死	死	sɿ³⁵	文讀
賜	赐	sɿ⁴⁴	
四	四	sɿ⁴⁴	
肆	肆	sɿ⁴⁴	
試	试	sɿ⁴⁴	
匙	匙	zɿ²²¹	
時	时	zɿ²²¹	
祠	祠	zɿ²²¹	
耜	耜	zɿ²²¹	耜頭
飼	饲	zɿ²²¹	
似	似	zɿ¹³	
祀	祀	zɿ¹³	
巳	巳	zɿ¹³	
市	市	zɿ¹³	
士	士	zɿ¹³	
仕	仕	zɿ¹³	
柿	柿	zɿ¹³	
恃	恃	zɿ¹³	
俟	俟	zɿ¹³	
鰣	鲥	zɿ¹³	
是	是	zɿ¹³	
氏	氏	zɿ¹³	
誓	誓	zɿ¹³	
逝	逝	zɿ¹³	
字	字	zɿ¹³	
伺	伺	zɿ¹³	
寺	寺	zɿ¹³	
事	事	zɿ¹³	
侍	侍	zɿ¹³	
示	示	zɿ¹³	
視	视	zɿ¹³	
嗜	嗜	zɿ¹³	
自	自	zɿ¹³	文讀
蓖	蓖	pi⁵³	
媲	媲	pi⁵³	
比	比	pi³⁵	
鄙	鄙	pi⁴⁴	
閉	闭	pi⁴⁴	
祕	秘	pi⁴⁴	
秘	秘	pi⁴⁴	
泌	泌	pi⁴⁴	
篦	篦	pi⁴⁴	
臂	臂	pi⁴⁴	
庇	庇	pi⁴⁴	包庇
批	批	pʰi⁵³	
披	披	pʰi⁵³	
砒	砒	pʰi⁵³	
紕	纰	pʰi⁵³	紕漏
痞	痞	pʰi⁵³	地痞
否	否	pʰi⁵³	否極泰來
譬	譬	pʰi⁴⁴	
屁	屁	pʰi⁴⁴	
皮	皮	bi²²¹	
疲	疲	bi²²¹	
脾	脾	bi²²¹	
琵	琵	bi²²¹	
枇	枇	bi²²¹	
婢	婢	bi²²¹	
陛	陛	bi²²¹	
痹	痹	bi²²¹	
俾	俾	bi²²¹	
蔽	蔽	bi²²¹	
幣	币	bi²²¹	
斃	毙	bi²²¹	
肥	肥	bi²²¹	白讀
敝	敝	bi¹³	
鐾	鐾	bi¹³	鐾刀
被	被	bi¹³	被頭
弊	弊	bi¹³	
避	避	bi¹³	
靡	靡	mi²²¹	
彌	弥	mi²²¹	
糜	糜	mi²²¹	
迷	迷	mi²²¹	
眉	眉	mi²²¹	白讀
謎	谜	mi²²¹	文讀
尾	尾	mi²²¹	白讀 尾巴
米	米	mi¹³	
味	味	mi¹³	白讀
未	未	mi¹³	白讀 還早未
微	微	ʔmi⁴⁴	白讀 微微小
非	非	fi⁵³	
飛	飞	fi⁵³	
妃	妃	fi⁵³	
榧	榧	fi⁵³	
匪	匪	fi⁵³	
沸	沸	fi⁵³	
誹	诽	fi⁵³	
廢	废	fi⁴⁴	
肺	肺	fi⁴⁴	
菲	菲	fi⁴⁴	
翡	翡	fi⁴⁴	
痱	痱	fi⁴⁴	
費	费	fi⁴⁴	費用
維	维	vi²²¹	
惟	惟	vi²²¹	
微	微	vi²²¹	文讀
唯	唯	vi¹³	
吠	吠	vi¹³	
肥	肥	vi¹³	文讀
尾	尾	vi¹³	文讀
味	味	vi¹³	文讀
未	未	vi¹³	文讀
費	费	vi¹³	姓
低	低	ti⁵³	
底	底	ti³⁵	
抵	抵	ti³⁵	
帝	帝	ti⁴⁴	
蒂	蒂	ti⁴⁴	蒂頭
締	缔	ti⁴⁴	
嚏	嚏	tʰi⁵³	
梯	梯	tʰi⁵³	
體	体	tʰi³⁵	
涕	涕	tʰi⁴⁴	
剃	剃	tʰi⁴⁴	
屜	屉	tʰi⁴⁴	
屉	屉	tʰi⁴⁴	
替	替	tʰi⁴⁴	
弟	弟	di²²¹	
逮	逮	di²²¹	
隸	隶	di²²¹	
隶	隶	di²²¹	
蹄	蹄	di²²¹	
啼	啼	di²²¹	
題	题	di¹³	
提	提	di¹³	
堤	堤	di¹³	
第	第	di¹³	
遞	递	di¹³	
地	地	di¹³	
你	你	ʔȵi⁴⁴	文讀
粘	粘	ʔȵi⁴⁴	粘結格牢
離	离	li²²¹	
璃	璃	li²²¹	
籬	篱	li²²¹	
勵	励	li²²¹	
荔	荔	li²²¹	
旅	旅	li²²¹	
犁	犁	li²²¹	
漓	漓	li²²¹	
梨	梨	li²²¹	
釐	厘	li²²¹	
狸	狸	li²²¹	
慮	虑	li²²¹	
麗	丽	li²²¹	
吏	吏	li²²¹	
俐	俐	li²²¹	
淚	泪	li²²¹	白讀
厲	厉	li¹³	
莉	莉	li¹³	
呂	吕	li¹³	
侶	侣	li¹³	
禮	礼	li¹³	
李	李	li¹³	
裏	里	li¹³	
里	里	li¹³	
裡	里	li¹³	
理	理	li¹³	
鯉	鲤	li¹³	
履	履	li¹³	
俚	俚	li¹³	
鋁	铝	li¹³	
黎	黎	li¹³	
濾	滤	li¹³	
例	例	li¹³	
利	利	li¹³	
痢	痢	li¹³	
娌	娌	li¹³	
机	机	tɕi⁵³	
機	机	tɕi⁵³	
稽	稽	tɕi⁵³	
譏	讥	tɕi⁵³	
飢	饥	tɕi⁵³	
饑	饥	tɕi⁵³	
肌	肌	tɕi⁵³	
姊	姊	tɕi⁵³	
悸	悸	tɕi⁵³	
箕	箕	tɕi⁵³	
姬	姬	tɕi⁵³	
幾	几	tɕi⁵³	幾乎
基	基	tɕi⁵³	基礎
擠	挤	tɕi³⁵	
己	己	tɕi³⁵	
雞	鸡	tɕi³⁵	
鷄	鸡	tɕi³⁵	
幾	几	tɕi³⁵	幾個
基	基	tɕi³⁵	基地
祭	祭	tɕi⁴⁴	
際	际	tɕi⁴⁴	
濟	济	tɕi⁴⁴	
劑	剂	tɕi⁴⁴	
計	计	tɕi⁴⁴	
繼	继	tɕi⁴⁴	
寄	寄	tɕi⁴⁴	
季	季	tɕi⁴⁴	
既	既	tɕi⁴⁴	
記	记	tɕi⁴⁴	
冀	冀	tɕi⁴⁴	
紀	纪	tɕi⁴⁴	
繫	系	tɕi⁴⁴	繫鞋帶
妻	妻	tɕʰi⁵³	
棲	栖	tɕʰi⁵³	
溪	溪	tɕʰi⁵³	
欺	欺	tɕʰi⁵³	
淒	凄	tɕʰi⁵³	
悽	凄	tɕʰi⁵³	
啓	启	tɕʰi³⁵	
啟	启	tɕʰi³⁵	
企	企	tɕʰi³⁵	
起	起	tɕʰi³⁵	
砌	砌	tɕʰi³⁵	
豈	岂	tɕʰi⁴⁴	
契	契	tɕʰi⁴⁴	
氣	气	tɕʰi⁴⁴	
汽	汽	tɕʰi⁴⁴	
器	器	tɕʰi⁴⁴	
棄	弃	tɕʰi⁴⁴	
楔	楔	tɕʰi⁴⁴	
杞	杞	tɕʰi⁴⁴	
碶	碶	tɕʰi⁴⁴	碶門
去	去	tɕʰi⁴⁴	白讀
蛆	蛆	tɕʰi⁴⁴	蛆蟲
苧	苎	dʑi²²¹	
薺	荠	dʑi²²¹	
峙	峙	dʑi²²¹	
臍	脐	dʑi²²¹	
奇	奇	dʑi²²¹	
騎	骑	dʑi²²¹	
其	其	dʑi²²¹	
棋	棋	dʑi²²¹	
碁	棋	dʑi²²¹	
期	期	dʑi²²¹	
旗	旗	dʑi²²¹	
祈	祈	dʑi²²¹	
鰭	鳍	dʑi²²¹	
嫉	嫉	dʑi²²¹	
齊	齐	dʑi²²¹	文讀
技	技	dʑi¹³	
痔	痔	dʑi¹³	
歧	歧	dʑi¹³	
妓	妓	dʑi¹³	
忌	忌	dʑi¹³	
崎	崎	dʑi¹³	
渠	渠	dʑi¹³	他
蟻	蚁	ȵi²²¹	
義	义	ȵi²²¹	
誼	谊	ȵi²²¹	
疑	疑	ȵi²²¹	
霓	霓	ȵi²²¹	
泥	泥	ȵi²²¹	
宜	宜	ȵi²²¹	
尼	尼	ȵi²²¹	
擬	拟	ȵi²²¹	
膩	腻	ȵi²²¹	
呢	呢	ȵi²²¹	
倪	倪	ȵi²²¹	姓
尾	尾	ȵi²²¹	白讀 尾巴
議	议	ȵi¹³	
儀	仪	ȵi¹³	
藝	艺	ȵi¹³	
毅	毅	ȵi¹³	
貳	贰	ȵi¹³	
二	二	ȵi¹³	白讀
耳	耳	ȵi¹³	白讀
西	西	ɕi⁵³	
犧	牺	ɕi⁵³	
希	希	ɕi⁵³	
稀	稀	ɕi⁵³	
嬉	嬉	ɕi⁵³	
熙	熙	ɕi⁵³	
璽	玺	ɕi⁵³	
徙	徙	ɕi⁵³	
髓	髓	ɕi⁵³	
犀	犀	ɕi⁵³	
世	世	ɕi⁵³	白讀
洗	洗	ɕi³⁵	
喜	喜	ɕi³⁵	
死	死	ɕi³⁵	白讀
細	细	ɕi⁴⁴	
婿	婿	ɕi⁴⁴	
戲	戏	ɕi⁴⁴	
絮	絮	ɕi⁴⁴	白讀 棉花絮
徐	徐	ʑi²²¹	
齊	齐	ʑi²²¹	白讀
余	余	ʑi²²¹	姓
自	自	ʑi¹³	白讀 自家人
鋸	锯	ki⁴⁴	白讀
兮	兮	ɦi²²¹	
遺	遗	ɦi²²¹	
姨	姨	ɦi²²¹	
矣	矣	ɦi²²¹	
夷	夷	ɦi²²¹	
異	异	ɦi²²¹	
肄	肄	ɦi²²¹	
胰	胰	ɦi²²¹	
移	移	ɦi²²¹	
頤	颐	ɦi²²¹	
繫	系	ɦi²²¹	聯繫
易	易	ɦi²²¹	容易
奚	奚	ɦi¹³	
又	又	ɦi¹³	白讀 又來啦
依	依	i⁵³	
醫	医	i⁵³	
伊	伊	i⁵³	
衣	衣	i⁵³	
倚	倚	i³⁵	
已	已	i³⁵	
以	以	i³⁵	
椅	椅	i³⁵	
意	意	i⁴⁴	
蔫	蔫	i⁴⁴	不新鮮
譜	谱	pu³⁵	
補	补	pu³⁵	
布	布	pu⁴⁴	
怖	怖	pu⁴⁴	
鋪	铺	pʰu⁵³	鋪陳
普	普	pʰu³⁵	
浦	浦	pʰu³⁵	
圃	圃	pʰu³⁵	
潽	潽	pʰu⁴⁴	水沸
鋪	铺	pʰu⁴⁴	鋪板
菩	菩	bu²²¹	
葡	葡	bu²²¹	
匍	匍	bu²²¹	
蒲	蒲	bu²²¹	
荸	荸	bu²²¹	荸薺
脯	脯	bu²²¹	胸脯
部	部	bu¹³	
簿	簿	bu¹³	
捕	捕	bu¹³	
哺	哺	bu¹³	
步	步	bu¹³	
埠	埠	bu¹³	
孵	孵	bu¹³	
殕	殕	bu¹³	白黴
呼	呼	fu⁵³	
夫	夫	fu⁵³	
膚	肤	fu⁵³	
敷	敷	fu⁵³	
俘	俘	fu⁵³	
麩	麸	fu⁵³	
甫	甫	fu⁵³	
脯	脯	fu⁵³	果脯
府	府	fu³⁵	
俯	俯	fu³⁵	
腑	腑	fu³⁵	
虎	虎	fu³⁵	
滸	浒	fu³⁵	
斧	斧	fu³⁵	
釜	釜	fu³⁵	
付	付	fu⁴⁴	
賦	赋	fu⁴⁴	
赴	赴	fu⁴⁴	
訃	讣	fu⁴⁴	
副	副	fu⁴⁴	
富	富	fu⁴⁴	
傅	傅	fu⁴⁴	
湖	湖	vu²²¹	
壺	壶	vu²²¹	
乎	乎	vu²²¹	
瓠	瓠	vu²²¹	
葫	葫	vu²²¹	
蕪	芜	vu²²¹	
婦	妇	vu²²¹	
巫	巫	vu²²¹	
蝴	蝴	vu²²¹	
弧	弧	vu²²¹	
狐	狐	vu²²¹	
糊	糊	vu²²¹	
滬	沪	vu²²¹	
浮	浮	vu²²¹	文讀
吳	吴	vu²²¹	文讀
胡	胡	vu²²¹	胡琴
務	务	vu¹³	
戶	户	vu¹³	
戸	户	vu¹³	
户	户	vu¹³	
伍	伍	vu¹³	
午	午	vu¹³	
腐	腐	vu¹³	
輔	辅	vu¹³	
武	武	vu¹³	
舞	舞	vu¹³	
侮	侮	vu¹³	
鵡	鹉	vu¹³	
父	父	vu¹³	
互	互	vu¹³	
符	符	vu¹³	
扶	扶	vu¹³	
芙	芙	vu¹³	
撫	抚	vu¹³	
誣	诬	vu¹³	
護	护	vu¹³	
附	附	vu¹³	
霧	雾	vu¹³	
戊	戊	vu¹³	
五	五	vu¹³	文讀
無	无	vu¹³	文讀
都	都	tu⁵³	
堵	堵	tu³⁵	
賭	赌	tu³⁵	
睹	睹	tu³⁵	
肚	肚	tu³⁵	豬肚
妒	妒	tu⁴⁴	
土	土	tʰu³⁵	
唾	唾	tʰu³⁵	涎唾
吐	吐	tʰu³⁵	吐痰
兔	兔	tʰu⁴⁴	
堍	堍	tʰu⁴⁴	堍頭
吐	吐	tʰu⁴⁴	嘔吐
徒	徒	du²²¹	
屠	屠	du²²¹	
途	途	du²²¹	
涂	涂	du²²¹	
塗	涂	du²²¹	
圖	图	du²²¹	
度	度	du¹³	
渡	渡	du¹³	
鍍	镀	du¹³	
杜	杜	du¹³	
肚	肚	du¹³	肚皮
努	努	nu¹³	
奴	奴	nu¹³	
娛	娱	nu¹³	
怒	怒	nu¹³	
悟	悟	nu¹³	
誤	误	nu¹³	
梧	梧	nu¹³	
弩	弩	nu¹³	
吾	吾	nu¹³	
晤	晤	nu¹³	
盧	卢	lu²²¹	
爐	炉	lu²²¹	
蘆	芦	lu²²¹	
鸕	鸬	lu²²¹	
廬	庐	lu²²¹	
驢	驴	lu²²¹	
路	路	lu¹³	
露	露	lu¹³	
鷺	鹭	lu¹³	
魯	鲁	lu¹³	
櫓	橹	lu¹³	
滷	卤	lu¹³	
鹵	卤	lu¹³	
租	租	tsu⁵³	
祖	祖	tsu³⁵	
組	组	tsu³⁵	
阻	阻	tsu³⁵	
詛	诅	tsu³⁵	
粗	粗	tsʰu⁵³	
初	初	tsʰu⁵³	
楚	楚	tsʰu⁵³	
礎	础	tsʰu⁵³	
醋	醋	tsʰu⁴⁴	
措	措	tsʰu⁴⁴	
助	助	dzu¹³	
鋤	锄	dzu¹³	
蘇	苏	su⁵³	
蔬	蔬	su⁵³	
疏	疏	su⁵³	
酥	酥	su⁵³	
鬚	须	su⁵³	牙鬚
數	数	su³⁵	文讀 數一數
素	素	su⁴⁴	
塑	塑	su⁴⁴	泥塑木雕
訴	诉	su⁴⁴	
數	数	su⁴⁴	數目
姑	姑	ku⁵³	
孤	孤	ku⁵³	
古	古	ku³⁵	
估	估	ku³⁵	
股	股	ku³⁵	
鼓	鼓	ku³⁵	
牯	牯	ku³⁵	
故	故	ku⁴⁴	
固	固	ku⁴⁴	
僱	雇	ku⁴⁴	
辜	辜	ku⁴⁴	
顧	顾	ku⁴⁴	
枯	枯	kʰu⁵³	
骷	骷	kʰu⁵³	
苦	苦	kʰu³⁵	
庫	库	kʰu⁴⁴	
褲	裤	kʰu⁴⁴	
絝	绔	kʰu⁴⁴	
咕	咕	ɡu²²¹	咕咕鳥叫
跍	跍	ɡu²²¹	蹲下
烏	乌	u⁵³	
污	污	u⁵³	
嗚	呜	u⁵³	
衣	衣	u⁵³	
熓	𤆡	u³⁵	火熄
椅	椅	u³⁵	
塢	坞	u⁴⁴	
惡	恶	u⁴⁴	可惡
焐	焐	u⁴⁴	煨
居	居	tɕy⁵³	
拘	拘	tɕy⁵³	
駒	驹	tɕy⁵³	
龜	龟	tɕy⁵³	白讀
歸	归	tɕy⁵³	白讀 歸家
車	车	tɕy⁵³	車馬炮
矩	矩	tɕy³⁵	
舉	举	tɕy³⁵	
鬼	鬼	tɕy³⁵	白讀
據	据	tɕy⁴⁴	
句	句	tɕy⁴⁴	
鋸	锯	tɕy⁴⁴	文讀
貴	贵	tɕy⁴⁴	白讀
區	区	tɕʰy⁵³	
驅	驱	tɕʰy⁵³	
軀	躯	tɕʰy⁵³	
蛆	蛆	tɕʰy⁵³	文讀
虧	亏	tɕʰy⁴⁴	白讀 虧了
去	去	tɕʰy⁴⁴	文讀
距	距	dʑy¹³	
炬	炬	dʑy¹³	
具	具	dʑy¹³	
瞿	瞿	dʑy¹³	
巨	巨	dʑy¹³	
拒	拒	dʑy¹³	
俱	俱	dʑy¹³	
懼	惧	dʑy¹³	
衢	衢	dʑy¹³	
攫	攫	dʑy¹³	
跪	跪	dʑy¹³	白讀
櫃	柜	dʑy¹³	白讀
渠	渠	dʑy¹³	水渠
語	语	ȵy²²¹	
虞	虞	ȵy²²¹	姓
愚	愚	ȵy²²¹	
禺	禺	ȵy²²¹	
女	女	ȵy¹³	
遇	遇	ȵy¹³	
寓	寓	ȵy¹³	
餌	饵	ȵy¹³	餌頭
蕊	蕊	ȵy¹³	白讀 蕊頭 蓓蕾
虛	虚	ɕy⁵³	
噓	嘘	ɕy⁵³	
墟	墟	ɕy⁵³	
靴	靴	ɕy⁵³	
鞾	靴	ɕy⁵³	
許	许	ɕy³⁵	
與	与	ɦy²²¹	
宇	宇	ɦy²²¹	
禹	禹	ɦy²²¹	
輿	舆	ɦy²²¹	
盂	盂	ɦy²²¹	
籲	吁	ɦy²²¹	
竽	竽	ɦy²²¹	
余	余	ɦy²²¹	我
餘	余	ɦy²²¹	
漁	渔	ɦy²²¹	
榆	榆	ɦy²²¹	
愉	愉	ɦy²²¹	
豫	豫	ɦy²²¹	
喻	喻	ɦy²²¹	
裕	裕	ɦy²²¹	
逾	逾	ɦy²²¹	
渝	渝	ɦy²²¹	
愈	愈	ɦy²²¹	
諭	谕	ɦy²²¹	
魚	鱼	ɦy²²¹	文讀
圍	围	ɦy²²¹	白讀
羽	羽	ɦy¹³	
譽	誉	ɦy¹³	
雨	雨	ɦy¹³	
預	预	ɦy¹³	
御	御	ɦy¹³	
予	予	ɦy¹³	
于	于	y⁵³	
於	於	y⁵³	
迂	迂	y⁵³	
淤	淤	y⁴⁴	
瘀	瘀	y⁴⁴	
喂	喂	y⁴⁴	白讀 喂飯
蛛	蛛	tʃʯ⁵³	
朱	朱	tʃʯ⁵³	
珠	珠	tʃʯ⁵³	
知	知	tʃʯ⁵³	
智	智	tʃʯ⁵³	
株	株	tʃʯ⁵³	
諸	诸	tʃʯ⁵³	
致	致	tʃʯ⁵³	
侏	侏	tʃʯ⁵³	
疰	疰	tʃʯ⁵³	疰夏
蜘	蜘	tʃʯ⁵³	文讀
錐	锥	tʃʯ⁵³	白讀 錐鞋
豬	猪	tʃʯ³⁵	
主	主	tʃʯ³⁵	
嘴	嘴	tʃʯ³⁵	
拄	拄	tʃʯ⁴⁴	
著	著	tʃʯ⁴⁴	
蛀	蛀	tʃʯ⁴⁴	
注	注	tʃʯ⁴⁴	
鑄	铸	tʃʯ⁴⁴	
制	制	tʃʯ⁴⁴	
置	置	tʃʯ⁴⁴	
誅	诛	tʃʯ⁴⁴	
駐	驻	tʃʯ⁴⁴	
癡	痴	tʃʰʯ⁵³	
媸	媸	tʃʰʯ⁵³	
嗤	嗤	tʃʰʯ⁵³	
侈	侈	tʃʰʯ⁵³	
趣	趣	tʃʰʯ⁵³	
趨	趋	tʃʰʯ⁵³	
糍	糍	tʃʰʯ⁵³	糍飯
餈	餈	tʃʰʯ⁵³	餈飯
吹	吹	tʃʰʯ⁵³	白讀
取	取	tʃʰʯ³⁵	
娶	娶	tʃʰʯ³⁵	
鼠	鼠	tʃʰʯ³⁵	文讀
處	处	tʃʰʯ³⁵	相處
恥	耻	tʃʰʯ⁴⁴	
處	处	tʃʰʯ⁴⁴	處所
除	除	dʒʯ²²¹	
池	池	dʒʯ²²¹	
持	持	dʒʯ²²¹	
遲	迟	dʒʯ²²¹	
馳	驰	dʒʯ²²¹	
弛	弛	dʒʯ²²¹	
廚	厨	dʒʯ²²¹	
住	住	dʒʯ²²¹	
治	治	dʒʯ²²¹	
稚	稚	dʒʯ²²¹	
櫥	橱	dʒʯ²²¹	
捶	捶	dʒʯ²²¹	白讀 捶背
錘	锤	dʒʯ²²¹	白讀 秤錘
滯	滞	dʒʯ¹³	滯底
柱	柱	dʒʯ¹³	
槌	槌	dʒʯ¹³	白讀 甩鑼槌
垂	垂	dʒʯ¹³	白讀 垂落
書	书	ʃʯ⁵³	
舒	舒	ʃʯ⁵³	
需	需	ʃʯ⁵³	
暑	暑	ʃʯ⁵³	
豕	豕	ʃʯ⁵³	
黍	黍	ʃʯ⁵³	
尿	尿	ʃʯ⁵³	白讀
歲	岁	ʃʯ⁵³	白讀
須	须	ʃʯ⁵³	必須
輸	输	ʃʯ⁵³	運輸
水	水	ʃʯ³⁵	白讀
數	数	ʃʯ³⁵	白讀 數一數
庶	庶	ʃʯ⁴⁴	
恕	恕	ʃʯ⁴⁴	
勢	势	ʃʯ⁴⁴	
貰	贳	ʃʯ⁴⁴	
絮	絮	ʃʯ⁴⁴	文讀
世	世	ʃʯ⁴⁴	文讀
輸	输	ʃʯ⁴⁴	輸贏
如	如	ʒʯ²²¹	
殊	殊	ʒʯ²²¹	
抒	抒	ʒʯ²²¹	
茹	茹	ʒʯ²²¹	
曙	曙	ʒʯ²²¹	
墅	墅	ʒʯ²²¹	
乳	乳	ʒʯ²²¹	
汝	汝	ʒʯ²²¹	
儒	儒	ʒʯ²²¹	
孺	孺	ʒʯ²²¹	
誰	谁	ʒʯ²²¹	白讀 誰儂
樹	树	ʒʯ²²¹	樹立
敘	叙	ʒʯ¹³	
聚	聚	ʒʯ¹³	
儲	储	ʒʯ¹³	
序	序	ʒʯ¹³	
緒	绪	ʒʯ¹³	
署	署	ʒʯ¹³	
薯	薯	ʒʯ¹³	
豉	豉	ʒʯ¹³	豆豉
貯	贮	ʒʯ¹³	
豎	竖	ʒʯ¹³	
樹	树	ʒʯ¹³	樹木
擺	摆	pa³⁵	
叭	叭	pa³⁵	
拜	拜	pa⁴⁴	
湃	湃	pa⁴⁴	
派	派	pʰa⁴⁴	
排	排	ba²²¹	
牌	牌	ba²²¹	
徘	徘	ba²²¹	
敗	败	ba¹³	
罷	罢	ba¹³	罷了
埋	埋	ma²²¹	白讀
買	买	ma¹³	
賣	卖	ma¹³	
帶	带	ta⁴⁴	
戴	戴	ta⁴⁴	白讀
他	他	tʰa⁵³	
汰	汰	tʰa⁵³	
太	太	tʰa⁴⁴	
泰	泰	tʰa⁴⁴	
埭	埭	da²²¹	走一埭
大	大	da¹³	文讀
奶	奶	na¹³	奶粉
奈	奈	na¹³	白讀
那	那	ʔna⁴⁴	
賴	赖	la¹³	白讀
癩	癞	la¹³	
喇	喇	la¹³	
拉	拉	ʔla⁴⁴	
齋	斋	tsa⁵³	
追	追	tsa⁵³	白讀
債	债	tsa⁴⁴	
蔡	蔡	tsʰa⁵³	姓
差	差	tsʰa⁵³	差使
怎	怎	dza¹³	白讀
咋	咋	dza¹³	怎麼
撒	撒	dza¹³	撒尿
曬	晒	sa⁵³	
灑	洒	sa³⁵	
豺	豺	za²²¹	
寨	寨	za²²¹	
柴	柴	za²²¹	
街	街	ka⁵³	
階	阶	ka⁵³	白讀
解	解	ka³⁵	解決
界	界	ka⁴⁴	
芥	芥	ka⁴⁴	
戒	戒	ka⁴⁴	
尬	尬	ka⁴⁴	尷尬
疥	疥	ka⁴⁴	
介	介	ka⁴⁴	白讀
屆	届	ka⁴⁴	白讀
隘	隘	ka⁴⁴	地名
揩	揩	kʰa⁵³	
楷	楷	kʰa⁵³	
卡	卡	kʰa⁵³	
嘎	嘎	ɡa²²¹	
解	解	ɡa¹³	鋸開
外	外	ŋa¹³	白讀
雁	雁	ŋa¹³	白讀 雁鵝
捱	挨	ŋa¹³	捱辰光
蟹	蟹	ha³⁵	
哈	哈	ha⁴⁴	
鞋	鞋	ɦa²²¹	
啊	啊	ɦa²²¹	
埃	埃	a⁵³	
鴉	鸦	a⁵³	白讀 鴉片
鵶	鸦	a⁵³	白讀 鴉片
挨	挨	a⁵³	挨次
阿	阿	a⁵³	阿哥
矮	矮	a³⁵	
阿	阿	a⁴⁴	文讀 阿姆 傭人
爹	爹	tia⁵³	白讀
佳	佳	tɕia⁵³	
姐	姐	tɕia⁵³	
家	家	tɕia⁵³	文讀
嘉	嘉	tɕia⁵³	文讀
借	借	tɕia⁴⁴	
笡	笡	tɕʰia³⁵	斜
欺	欺	tɕʰia⁴⁴	欺詐
茄	茄	dʑia²²¹	
寫	写	ɕia³⁵	
瀉	泻	ɕia⁴⁴	
卸	卸	ɕia⁴⁴	
邪	邪	ʑia²²¹	
謝	谢	ʑia¹³	
斜	斜	ʑia¹³	
崖	崖	ɦia²²¹	
涯	涯	ɦia²²¹	
爺	爷	ɦia²²¹	白讀
也	也	ɦia¹³	白讀
野	野	ɦia¹³	白讀
夜	夜	ɦia¹³	白讀
呀	呀	ia⁵³	
雅	雅	ia³⁵	
亞	亚	ia⁴⁴	
霞	霞	ia⁴⁴	晚霞
鴉	鸦	ia⁴⁴	文讀 烏鴉
鵶	鸦	ia⁴⁴	文讀 烏鵶
拐	拐	kua³⁵	
怪	怪	kua³⁵	奇怪
怪	怪	kua⁴⁴	怪罪
快	快	kʰua⁴⁴	
懷	怀	ɡua²²¹	白讀
歪	歪	hua⁴⁴	
歪	歪	ua⁵³	
哇	哇	ua⁵³	
壞	坏	ua⁴⁴	
芭	芭	po⁵³	
笆	笆	po⁵³	
巴	巴	po⁵³	巴結
把	把	po³⁵	
靶	靶	po³⁵	
霸	霸	po⁴⁴	
壩	坝	po⁴⁴	
疤	疤	po⁴⁴	
怕	怕	pʰo⁴⁴	
爬	爬	bo²²¹	
琶	琶	bo²²¹	
吧	吧	bo²²¹	
扒	扒	bo²²¹	
杷	杷	bo²²¹	
罷	罢	bo²²¹	罷工
巴	巴	bo²²¹	下巴
耙	耙	bo¹³	
稗	稗	bo¹³	稗草
䶕	𫜨	bo¹³	䶕牙
麻	麻	mo²²¹	
嗎	吗	mo²²¹	
螞	蚂	mo²²¹	
馬	马	mo¹³	
碼	码	mo¹³	
瑪	玛	mo¹³	
罵	骂	mo¹³	
媽	妈	ʔmo⁴⁴	
垛	垛	to⁵³	
朵	朵	to³⁵	
躲	躲	to³⁵	
剁	剁	to⁴⁴	
跖	跖	tʰo³⁵	跖鞋底
大	大	do¹³	大家
孥	孥	no²²¹	兒孥
女	女	no²²¹	兒女
拿	拿	no¹³	
挪	挪	no¹³	
遮	遮	tso⁵³	
渣	渣	tso⁵³	
蔗	蔗	tso⁴⁴	
詐	诈	tso⁴⁴	
榨	榨	tso⁴⁴	
炸	炸	tso⁴⁴	
乍	乍	tso⁴⁴	忽然
柞	柞	tso⁴⁴	
抓	抓	tso⁴⁴	
叉	叉	tsʰo⁵³	
杈	杈	tsʰo⁵³	
釵	钗	tsʰo⁵³	白讀
差	差	tsʰo⁵³	差別
車	车	tsʰo⁵³	
扯	扯	tsʰo³⁵	
岔	岔	tsʰo⁴⁴	
茶	茶	dzo²²¹	
搽	搽	dzo²²¹	
查	查	dzo²²¹	
乍	乍	dzo²²¹	乍浦
賒	赊	so⁵³	
沙	沙	so⁵³	
紗	纱	so⁵³	
莎	莎	so⁵³	
蓑	蓑	so⁵³	
痧	痧	so⁵³	
所	所	so³⁵	
赦	赦	so³⁵	
捨	舍	so³⁵	白讀 捨棄
舍	舍	so⁴⁴	白讀 鄰舍
蛇	蛇	zo²²¹	
佘	佘	zo²²¹	姓
社	社	zo¹³	
惹	惹	zo¹³	
麝	麝	zo¹³	
加	加	ko⁵³	
家	家	ko⁵³	白讀
嘉	嘉	ko⁵³	白讀
賈	贾	ko³⁵	
假	假	ko³⁵	真假
架	架	ko⁴⁴	
嫁	嫁	ko⁴⁴	
價	价	ko⁴⁴	
駕	驾	ko⁴⁴	
稼	稼	ko⁴⁴	
假	假	ko⁴⁴	放假
抲	抲	kʰo⁴⁴	捉
跨	跨	ɡo²²¹	白讀 跨過去
牙	牙	ŋo²²¹	
芽	芽	ŋo²²¹	
衙	衙	ŋo²²¹	
鬍	胡	ŋo²²¹	鬍須
瓦	瓦	ŋo¹³	
砑	砑	ŋo¹³	砑光
我	我	ŋo¹³	
蝦	虾	ho³⁵	
呵	呵	ho⁴⁴	呵癢
下	下	ɦo¹³	
夏	夏	ɦo¹³	
廈	厦	ɦo¹³	
丫	丫	o⁵³	丫頭
椏	桠	o⁵³	椏杈
阿	阿	o⁵³	阿彌陀佛
啞	哑	o³⁵	
鴉	鸦	o³⁵	白讀 老鴉
鵶	鸦	o³⁵	白讀 老鵶
掗	掗	o⁴⁴	掗賣豆腐
彪	彪	pio⁵³	
鏢	镖	pio⁵³	
鑣	镳	pio⁵³	
飆	飙	pio⁵³	
膘	膘	pio⁵³	
標	标	pio⁵³	
表	表	pio³⁵	
婊	婊	pio³⁵	
裱	裱	pio³⁵	
飄	飘	pʰio⁵³	
漂	漂	pʰio⁵³	漂浮
漂	漂	pʰio³⁵	漂白
票	票	pʰio⁴⁴	
瓢	瓢	bio²²¹	
嫖	嫖	bio²²¹	
剽	剽	bio²²¹	
鰾	鳔	bio¹³	
苗	苗	mio²²¹	
描	描	mio²²¹	
瞄	瞄	mio²²¹	
謬	谬	mio²²¹	
藐	藐	mio¹³	
渺	渺	mio¹³	
秒	秒	mio¹³	
廟	庙	mio¹³	
妙	妙	mio¹³	
繆	缪	mio¹³	姓
刁	刁	tio⁵³	
貂	貂	tio⁵³	
雕	雕	tio⁵³	
鳥	鸟	tio³⁵	白讀
窵	窎	tio³⁵	窵角
釣	钓	tio⁴⁴	
吊	吊	tio⁴⁴	
凋	凋	tio⁴⁴	
碉	碉	tio⁴⁴	
挑	挑	tʰio⁵³	
糶	粜	tʰio⁵³	
跳	跳	tʰio⁴⁴	
條	条	dio²²¹	
迢	迢	dio²²¹	
掉	掉	dio¹³	
調	调	dio¹³	
燎	燎	lio²²¹	
遼	辽	lio²²¹	
寥	寥	lio²²¹	白讀
療	疗	lio²²¹	
僚	僚	lio²²¹	
鐐	镣	lio²²¹	
了	了	lio²²¹	來了
聊	聊	lio¹³	
撩	撩	lio¹³	水中撈物
蹽	蹽	lio¹³	抄近路
瞭	了	lio¹³	明瞭
焦	焦	tɕio⁵³	
蕉	蕉	tɕio⁵³	
椒	椒	tɕio⁵³	
昭	昭	tɕio⁵³	
招	招	tɕio⁵³	
嬌	娇	tɕio⁵³	
驕	骄	tɕio⁵³	
郊	郊	tɕio⁵³	
澆	浇	tɕio⁵³	
矯	矫	tɕio⁵³	
沼	沼	tɕio⁵³	
繳	缴	tɕio⁵³	
狡	狡	tɕio⁵³	
礁	礁	tɕio⁵³	
釗	钊	tɕio⁵³	
蛟	蛟	tɕio⁵³	
姣	姣	tɕio⁵³	
皎	皎	tɕio⁵³	
交	交	tɕio⁵³	文讀
膠	胶	tɕio⁵³	文讀
茭	茭	tɕio⁵³	文讀
覺	觉	tɕio⁵³	文讀 睡覺
朝	朝	tɕio⁵³	明朝
餃	饺	tɕio³⁵	
絞	绞	tɕio³⁵	文讀
鉸	铰	tɕio³⁵	文讀
照	照	tɕio⁴⁴	
詔	诏	tɕio⁴⁴	
醮	醮	tɕio⁴⁴	
較	较	tɕio⁴⁴	
教	教	tɕio⁴⁴	文讀
叫	叫	tɕio⁴⁴	
校	校	tɕio⁴⁴	文讀 校對
超	超	tɕʰio⁵³	
俏	俏	tɕʰio⁵³	
敲	敲	tɕʰio⁵³	文讀
巧	巧	tɕʰio³⁵	
竅	窍	tɕʰio⁴⁴	
蹺	跷	tɕʰio⁴⁴	
翹	翘	tɕʰio⁴⁴	
喬	乔	dʑio²²¹	
僑	侨	dʑio²²¹	
橋	桥	dʑio²²¹	
蕎	荞	dʑio²²¹	
憔	憔	dʑio²²¹	
潮	潮	dʑio²²¹	
嘲	嘲	dʑio²²¹	
朝	朝	dʑio²²¹	朝代
轎	轿	dʑio¹³	
趙	赵	dʑio¹³	
撬	撬	dʑio¹³	
堯	尧	ȵio²²¹	
饒	饶	ȵio²²¹	
繞	绕	ȵio¹³	
鳥	鸟	ȵio¹³	文讀
銷	销	ɕio⁵³	
消	消	ɕio⁵³	
宵	宵	ɕio⁵³	
霄	霄	ɕio⁵³	
硝	硝	ɕio⁵³	
燒	烧	ɕio⁵³	
蕭	萧	ɕio⁵³	
簫	箫	ɕio⁵³	
肖	肖	ɕio⁵³	
嘯	啸	ɕio⁵³	
筱	筱	ɕio⁵³	
囂	嚣	ɕio⁵³	
瀟	潇	ɕio⁵³	
哨	哨	ɕio⁵³	
哮	哮	ɕio⁵³	文讀
𢳚	𫽐	ɕio⁵³	𢳚蓋子
曉	晓	ɕio³⁵	
小	小	ɕio³⁵	
少	少	ɕio³⁵	
笑	笑	ɕio⁴⁴	
孝	孝	ɕio⁴⁴	文讀
韶	韶	ʑio²²¹	
樵	樵	ʑio²²¹	
召	召	ʑio¹³	
邵	邵	ʑio¹³	
紹	绍	ʑio¹³	
兆	兆	ʑio¹³	
擾	扰	ʑio¹³	
肇	肇	ʑio¹³	
搖	摇	ɦio²²¹	
遙	遥	ɦio²²¹	
謠	谣	ɦio²²¹	
窯	窑	ɦio²²¹	
窑	窑	ɦio²²¹	
瑤	瑶	ɦio²²¹	
耀	耀	ɦio²²¹	
姚	姚	ɦio¹³	
餚	肴	ɦio¹³	
淆	淆	ɦio¹³	
鷂	鹞	ɦio¹³	
效	效	ɦio¹³	文讀
校	校	ɦio¹³	學校
妖	妖	io⁵³	
邀	邀	io⁵³	
腰	腰	io⁵³	
幺	幺	io⁵³	幺二三
夭	夭	io⁵³	
舀	舀	io³⁵	
要	要	io⁴⁴	
杳	杳	io⁴⁴	
僥	侥	io⁴⁴	
吆	吆	io⁴⁴	吆喝
瓜	瓜	kuo⁵³	
寡	寡	kuo⁵³	
剮	剐	kuo³⁵	
掛	挂	kuo⁴⁴	
褂	褂	kuo⁴⁴	
卦	卦	kuo⁴⁴	
誇	夸	kʰuo⁵³	
誇	夸	kʰuo⁵³	
胯	胯	kʰuo⁵³	
垮	垮	kʰuo⁵³	
訛	讹	ʔŋuo⁵³	訛詐
花	花	huo⁵³	
化	化	huo⁴⁴	
華	华	ɦuo²²¹	
畫	画	ɦuo¹³	
話	话	ɦuo¹³	
霞	霞	ɦuo¹³	霞浦漲
蛙	蛙	uo⁵³	
划	划	uo⁵³	划船
包	包	pɔ⁵³	
胞	胞	pɔ⁵³	
堡	堡	pɔ³⁵	
飽	饱	pɔ³⁵	
保	保	pɔ³⁵	
寶	宝	pɔ³⁵	
鴇	鸨	pɔ³⁵	
褒	褒	pɔ³⁵	
報	报	pɔ⁴⁴	
豹	豹	pɔ⁴⁴	
苞	苞	pɔ⁴⁴	
葆	葆	pɔ⁴⁴	
爆	爆	pɔ⁴⁴	爆裂
泡	泡	pʰɔ⁵³	
拋	抛	pʰɔ⁵³	
脬	脬	pʰɔ⁵³	
炮	炮	pʰɔ⁴⁴	
袍	袍	bɔ²²¹	
跑	跑	bɔ²²¹	
刨	刨	bɔ¹³	
褓	褓	bɔ¹³	
抱	抱	bɔ¹³	
鮑	鲍	bɔ¹³	姓
暴	暴	bɔ¹³	
庖	庖	bɔ¹³	
咆	咆	bɔ¹³	
爆	爆	bɔ¹³	爆炸
毛	毛	mɔ²²¹	
茅	茅	mɔ²²¹	
貌	貌	mɔ²²¹	
矛	矛	mɔ²²¹	
貓	猫	mɔ²²¹	
卯	卯	mɔ¹³	
冒	冒	mɔ¹³	
帽	帽	mɔ¹³	
錨	锚	mɔ¹³	
莫	莫	ʔmɔ⁴⁴	不要
刀	刀	tɔ⁵³	
島	岛	tɔ⁵³	
禱	祷	tɔ³⁵	
搗	捣	tɔ³⁵	
倒	倒	tɔ³⁵	倒塌
到	到	tɔ⁴⁴	
倒	倒	tɔ⁴⁴	倒立
滔	滔	tʰɔ⁵³	
韜	韬	tʰɔ⁵³	
討	讨	tʰɔ³⁵	
套	套	tʰɔ⁴⁴	
叨	叨	tʰɔ⁴⁴	叨光
桃	桃	dɔ²²¹	
逃	逃	dɔ²²¹	
淘	淘	dɔ²²¹	
陶	陶	dɔ²²¹	
萄	萄	dɔ²²¹	
濤	涛	dɔ²²¹	
道	道	dɔ¹³	
稻	稻	dɔ¹³	
蹈	蹈	dɔ¹³	
盜	盗	dɔ¹³	
導	导	dɔ¹³	
悼	悼	dɔ¹³	
腦	脑	nɔ¹³	
惱	恼	nɔ¹³	
鬧	闹	nɔ¹³	
撓	挠	nɔ¹³	
勞	劳	lɔ²²¹	
牢	牢	lɔ²²¹	
蘿	萝	lɔ²²¹	白讀
老	老	lɔ¹³	
佬	佬	lɔ¹³	
撈	捞	ʔlɔ⁴⁴	
澇	涝	ʔlɔ⁴⁴	
遭	遭	tsɔ⁵³	
糟	糟	tsɔ⁵³	
搔	搔	tsɔ⁵³	
澡	澡	tsɔ⁵³	
蚤	蚤	tsɔ⁵³	
藻	藻	tsɔ⁵³	
早	早	tsɔ³⁵	
棗	枣	tsɔ³⁵	
爪	爪	tsɔ³⁵	
找	找	tsɔ³⁵	
躁	躁	tsɔ⁴⁴	
竈	灶	tsɔ⁴⁴	
罩	罩	tsɔ⁴⁴	
操	操	tsʰɔ⁵³	
抄	抄	tsʰɔ⁵³	
鈔	钞	tsʰɔ⁵³	
草	草	tsʰɔ³⁵	
炒	炒	tsʰɔ³⁵	
吵	吵	tsʰɔ³⁵	
糙	糙	tsʰɔ⁴⁴	
曹	曹	dzɔ²²¹	
巢	巢	dzɔ²²¹	
燥	燥	sɔ⁵³	
臊	臊	sɔ⁵³	
嫂	嫂	sɔ³⁵	
掃	扫	sɔ³⁵	掃地
梢	梢	sɔ⁴⁴	
稍	稍	sɔ⁴⁴	
騷	骚	sɔ⁴⁴	
掃	扫	sɔ⁴⁴	掃帚
槽	槽	zɔ²²¹	
皁	皂	zɔ²²¹	
造	造	zɔ¹³	
漕	漕	zɔ¹³	池塘
高	高	kɔ⁵³	
膏	膏	kɔ⁵³	
交	交	kɔ⁵³	白讀
膠	胶	kɔ⁵³	白讀
茭	茭	kɔ⁵³	白讀 茭白
篙	篙	kɔ³⁵	
稿	稿	kɔ³⁵	
絞	绞	kɔ³⁵	白讀
鉸	铰	kɔ³⁵	白讀
羔	羔	kɔ⁴⁴	
糕	糕	kɔ⁴⁴	
告	告	kɔ⁴⁴	
教	教	kɔ⁴⁴	白讀
酵	酵	kɔ⁴⁴	白讀
覺	觉	kɔ⁴⁴	白讀 睏覺
叫	叫	kɔ⁴⁴	叫化子
校	校	kɔ⁴⁴	白讀 校場
敲	敲	kʰɔ⁵³	白讀
考	考	kʰɔ³⁵	
拷	拷	kʰɔ³⁵	
靠	靠	kʰɔ⁴⁴	
犒	犒	kʰɔ⁴⁴	
銬	铐	kʰɔ⁴⁴	
烤	烤	kʰɔ⁴⁴	
攪	搅	ɡɔ¹³	攪七廿三
傲	傲	ŋɔ²²¹	
熬	熬	ŋɔ²²¹	
敖	敖	ŋɔ²²¹	
螯	螯	ŋɔ²²¹	
鰲	鳌	ŋɔ²²¹	
嗷	嗷	ŋɔ²²¹	
遨	遨	ŋɔ²²¹	
翱	翱	ŋɔ²²¹	
咬	咬	ŋɔ¹³	
好	好	hɔ³⁵	
蒿	蒿	hɔ⁴⁴	
耗	耗	hɔ⁴⁴	
孝	孝	hɔ⁴⁴	白讀
哮	哮	hɔ⁴⁴	白讀
豪	豪	ɦɔ²²¹	
壕	壕	ɦɔ²²¹	
毫	毫	ɦɔ²²¹	
浩	浩	ɦɔ²²¹	
嚎	嚎	ɦɔ²²¹	
濠	濠	ɦɔ²²¹	
號	号	ɦɔ¹³	
效	效	ɦɔ¹³	白讀 效氣
襖	袄	ɔ³⁵	
拗	拗	ɔ³⁵	拗斷
奧	奥	ɔ⁴⁴	
懊	懊	ɔ⁴⁴	
澳	澳	ɔ⁴⁴	
凹	凹	ɔ⁴⁴	
鏖	鏖	ɔ⁴⁴	
嶴	岙	ɔ⁴⁴	
拗	拗	ɔ⁴⁴	拗攪，拗猛江
班	班	pɛ⁵³	
斑	斑	pɛ⁵³	
扳	扳	pɛ⁵³	
般	般	pɛ⁵³	
頒	颁	pɛ⁵³	
瘢	瘢	pɛ⁵³	
掰	掰	pɛ⁵³	掰開
板	板	pɛ³⁵	
版	版	pɛ³⁵	
阪	阪	pɛ³⁵	
坂	坂	pɛ³⁵	田坂
扮	扮	pɛ⁴⁴	
絆	绊	pɛ⁴⁴	絆一跌
攀	攀	pʰɛ⁵³	
襻	襻	pʰɛ⁵³	紐襻
帕	帕	pʰɛ⁵³	兒化變讀 絹帕
盼	盼	pʰɛ⁴⁴	
牌	牌	bɛ²²¹	兒化變讀 麻雀牌
瓣	瓣	bɛ¹³	
辦	办	bɛ¹³	
爿	爿	bɛ¹³	
曼	曼	mɛ²²¹	
蔓	蔓	mɛ²²¹	
邁	迈	mɛ²²¹	
埋	埋	mɛ²²¹	文讀
漫	漫	mɛ²²¹	文讀
蠻	蛮	mɛ²²¹	野蠻
貓	猫	mɛ²²¹	兒化變讀
爿	爿	mɛ²²¹	
慢	慢	mɛ¹³	
萬	万	mɛ¹³	白讀 萬子
晚	晚	mɛ¹³	白讀 晚娘
蠻	蛮	ʔmɛ⁴⁴	蠻好
翻	翻	fɛ⁵³	
番	番	fɛ⁵³	
髮	发	fɛ⁵³	兒化變讀 看髮 劉海
反	反	fɛ³⁵	
返	返	fɛ³⁵	
泛	泛	fɛ⁴⁴	
販	贩	fɛ⁴⁴	
帆	帆	vɛ²²¹	
藩	藩	vɛ²²¹	
煩	烦	vɛ²²¹	
繁	繁	vɛ²²¹	
樊	樊	vɛ²²¹	
礬	矾	vɛ²²¹	
蕃	蕃	vɛ²²¹	
凡	凡	vɛ¹³	
範	范	vɛ¹³	
飯	饭	vɛ¹³	
犯	犯	vɛ¹³	
萬	万	vɛ¹³	文讀
晚	晚	vɛ¹³	文讀
丹	丹	tɛ⁵³	
單	单	tɛ⁵³	
擔	担	tɛ⁵³	擔任
兜	兜	tɛ⁵³	兒化變讀 飯兜
膽	胆	tɛ³⁵	
撣	掸	tɛ³⁵	
疸	疸	tɛ³⁵	
耽	耽	tɛ⁴⁴	
旦	旦	tɛ⁴⁴	
擔	担	tɛ⁴⁴	挑擔
坍	坍	tʰɛ⁵³	
灘	滩	tʰɛ⁵³	
攤	摊	tʰɛ⁵³	
癱	瘫	tʰɛ⁵³	
坦	坦	tʰɛ³⁵	
毯	毯	tʰɛ³⁵	
炭	炭	tʰɛ⁴⁴	
嘆	叹	tʰɛ⁴⁴	
談	谈	dɛ²²¹	
痰	痰	dɛ²²¹	
檀	檀	dɛ²²¹	
壇	坛	dɛ²²¹	
誕	诞	dɛ²²¹	
譚	谭	dɛ²²¹	
潭	潭	dɛ²²¹	文讀
燂	燂	dɛ²²¹	燒水
彈	弹	dɛ²²¹	彈性
頭	头	dɛ²²¹	兒化變讀 馬蘭頭
但	但	dɛ¹³	
淡	淡	dɛ¹³	
蛋	蛋	dɛ¹³	
彈	弹	dɛ¹³	彈子
難	难	nɛ²²¹	困難
乃	乃	nɛ¹³	
難	难	nɛ¹³	難民
奈	奈	nɛ¹³	文讀
籃	篮	lɛ²²¹	
藍	蓝	lɛ²²¹	
蘭	兰	lɛ²²¹	
闌	阑	lɛ²²¹	
讕	谰	lɛ²²¹	
瀾	澜	lɛ²²¹	
欖	榄	lɛ²²¹	
攔	拦	lɛ²²¹	文讀
欄	栏	lɛ²²¹	文讀
纜	缆	lɛ¹³	
覽	览	lɛ¹³	
攬	揽	lɛ¹³	
懶	懒	lɛ¹³	
濫	滥	lɛ¹³	
爛	烂	lɛ¹³	
賴	赖	lɛ¹³	文讀
贊	赞	tsɛ⁴⁴	
讚	赞	tsɛ⁴⁴	
斬	斩	tsɛ⁴⁴	
盞	盏	tsɛ⁴⁴	
濺	溅	tsɛ⁴⁴	
餐	餐	tsʰɛ⁵³	
攙	搀	tsʰɛ⁵³	
羼	羼	tsʰɛ⁵³	
參	参	tsʰɛ⁵³	參加
菜	菜	tsʰɛ⁵³	兒化變讀 花臉菜 薺菜
慘	惨	tsʰɛ³⁵	
產	产	tsʰɛ³⁵	
鏟	铲	tsʰɛ³⁵	
燦	灿	tsʰɛ⁴⁴	
懺	忏	tsʰɛ⁴⁴	拜懺
慚	惭	dzɛ²²¹	
殘	残	dzɛ²²¹	
讒	谗	dzɛ²²¹	
饞	馋	dzɛ²²¹	
暫	暂	dzɛ¹³	
綻	绽	dzɛ¹³	
棧	栈	dzɛ¹³	
站	站	dzɛ¹³	
賺	赚	dzɛ¹³	
三	三	sɛ⁵³	
杉	杉	sɛ⁵³	
衫	衫	sɛ⁵³	
珊	珊	sɛ⁵³	
山	山	sɛ⁵³	
傘	伞	sɛ⁵³	
刪	删	sɛ⁵³	
散	散	sɛ³⁵	
散	散	sɛ⁴⁴	
柴	柴	zɛ²²¹	兒化變讀 草柴
涎	涎	zɛ²²¹	
尷	尴	kɛ⁵³	
奸	奸	kɛ⁵³	
橄	橄	kɛ³⁵	
減	减	kɛ³⁵	
揀	拣	kɛ³⁵	
鹼	碱	kɛ³⁵	
襉	裥	kɛ³⁵	
襇	裥	kɛ³⁵	
柬	柬	kɛ³⁵	白讀
監	监	kɛ⁴⁴	
間	间	kɛ⁴⁴	白讀
堪	堪	kʰɛ⁵³	
嵌	嵌	kʰɛ⁵³	
坎	坎	kʰɛ⁵³	
砍	砍	kʰɛ⁵³	
艦	舰	kʰɛ⁵³	
勘	勘	kʰɛ⁵³	
刊	刊	kʰɛ⁵³	
鉛	铅	kʰɛ⁵³	
檻	槛	kʰɛ⁵³	門檻
戡	戡	kʰɛ⁵³	
龕	龛	kʰɛ⁵³	神龕
諫	谏	ɡɛ¹³	白讀 諫嘴
巖	岩	ŋɛ²²¹	
岩	岩	ŋɛ²²¹	
銜	衔	ŋɛ²²¹	
癌	癌	ŋɛ²²¹	
顏	颜	ŋɛ²²¹	白讀
岸	岸	ŋɛ²²¹	白讀
雁	雁	ŋɛ²²¹	白讀
眼	眼	ŋɛ¹³	
瞎	瞎	hɛ⁵³	兒化變讀 算命瞎子
喊	喊	hɛ³⁵	
莧	苋	hɛ⁴⁴	莧菜
鹹	咸	ɦɛ²²¹	鹹淡
閒	闲	ɦɛ²²¹	
閑	闲	ɦɛ²²¹	
盒	盒	ɦɛ²²¹	兒化變讀 撲粉盒
濠	濠	ɦɛ²²¹	兒化變讀 濠河頭
限	限	ɦɛ⁴⁴	
餡	馅	ɦɛ⁴⁴	
陷	陷	ɦɛ⁴⁴	白讀
鴨	鸭	ɛ³⁵	兒化變讀
晏	晏	ɛ⁴⁴	遲
矮	矮	ɛ⁴⁴	兒化變讀 稱呼矮子
鰥	鳏	kuɛ⁵³	
關	关	kuɛ⁵³	
関	关	kuɛ⁵³	
慣	惯	kuɛ⁴⁴	
筷	筷	kʰuɛ⁵³	兒化變讀
摜	掼	ɡuɛ¹³	
甩	甩	ɡuɛ¹³	
乖	乖	huɛ⁵³	
環	环	ɦuɛ²²¹	
玩	玩	ɦuɛ²²¹	
頑	顽	ɦuɛ²²¹	
幻	幻	ɦuɛ²²¹	
還	还	ɦuɛ²²¹	還是 歸還
患	患	ɦuɛ²²¹	
宦	宦	ɦuɛ²²¹	
淮	淮	ɦuɛ²²¹	
壞	坏	ɦuɛ²²¹	文讀
懷	怀	ɦuɛ²²¹	文讀
槐	槐	ɦuɛ²²¹	
彎	弯	uɛ⁵³	
灣	湾	uɛ⁵³	
娃	娃	uɛ⁵³	兒化變讀 小娃
挽	挽	uɛ³⁵	
𧟰	𧟰	fᴇ⁵³	不要
覅	𧟰	fᴇ⁵³	不要
𡠍	𧟰	fᴇ⁵³	不要
𫸻	𧟰	fᴇ⁵³	不要
戴	戴	tᴇ⁵³	文讀
胎	胎	tʰᴇ⁵³	
台	台	tʰᴇ⁵³	台州
苔	苔	tʰᴇ⁵³	舌苔
梯	梯	tʰᴇ⁵³	路梯
態	态	tʰᴇ⁴⁴	
擡	抬	dᴇ²²¹	
貸	贷	dᴇ²²¹	
臺	台	dᴇ²²¹	戲臺
苔	苔	dᴇ²²¹	苔條
待	待	dᴇ¹³	
怠	怠	dᴇ¹³	
殆	殆	dᴇ¹³	
代	代	dᴇ¹³	
袋	袋	dᴇ¹³	
耐	耐	nᴇ¹³	
念	念	nᴇ¹³	
廿	廿	nᴇ¹³	
驗	验	nᴇ¹³	
騐	验	nᴇ¹³	
奶	奶	ʔnᴇ⁴⁴	兒化變讀 奶奶脯
來	来	lᴇ²²¹	
災	灾	tsᴇ⁵³	
栽	栽	tsᴇ⁵³	
宰	宰	tsᴇ⁵³	
哉	哉	tsᴇ⁵³	
再	再	tsᴇ⁴⁴	
載	载	tsᴇ⁴⁴	載重
猜	猜	tsʰᴇ⁵³	
釵	钗	tsʰᴇ⁵³	文讀
且	且	tsʰᴇ³⁵	
採	采	tsʰᴇ³⁵	
采	采	tsʰᴇ³⁵	
彩	彩	tsʰᴇ³⁵	
綵	彩	tsʰᴇ³⁵	
睬	睬	tsʰᴇ³⁵	
菜	菜	tsʰᴇ⁴⁴	
才	才	dzᴇ²²¹	
財	财	dzᴇ²²¹	
材	材	dzᴇ²²¹	木材
在	在	dzᴇ¹³	
腮	腮	sᴇ⁵³	
鰓	鳃	sᴇ⁵³	
衰	衰	sᴇ⁵³	
帥	帅	sᴇ⁵³	
賽	赛	sᴇ⁴⁴	
裁	裁	zᴇ²²¹	
載	载	zᴇ²²¹	載子
材	材	zᴇ²²¹	棺材
改	改	kᴇ³⁵	
該	该	kᴇ³⁵	
開	开	kʰᴇ⁵³	
凱	凯	kʰᴇ⁵³	
慨	慨	kʰᴇ⁴⁴	
戤	戤	ɡᴇ¹³	斜靠
䬵	䬵	ɡᴇ¹³	打嗝
呆	呆	ŋᴇ²²¹	
礙	碍	ŋᴇ¹³	
艾	艾	ŋᴇ¹³	
海	海	hᴇ³⁵	
孩	孩	ɦᴇ²²¹	
亥	亥	ɦᴇ¹³	
害	害	ɦᴇ¹³	
哀	哀	ᴇ⁵³	
愛	爱	ᴇ³⁵	
藹	蔼	ᴇ³⁵	
爹	爹	tiᴇ⁵³	文讀
皆	皆	tɕiᴇ⁵³	
階	阶	tɕiᴇ⁵³	文讀
介	介	tɕiᴇ⁴⁴	文讀
屆	届	tɕiᴇ⁴⁴	文讀
茄	茄	dʑiᴇ¹³	兒化變讀
驗	验	ȵiᴇ¹³	
騐	验	ȵiᴇ¹³	
耶	耶	ɦiᴇ²²¹	
械	械	ɦiᴇ²²¹	
爺	爷	ɦiᴇ²²¹	文讀
椰	椰	ɦiᴇ¹³	
也	也	ɦiᴇ¹³	文讀
夜	夜	ɦiᴇ¹³	文讀
野	野	ɦiᴇ¹³	文讀
外	外	ɦuᴇ¹³	文讀
搬	搬	pø⁵³	
巴	巴	pø⁵³	兒化變讀 尾巴
半	半	pø⁴⁴	
判	判	pʰø⁴⁴	
潘	潘	pʰø⁴⁴	姓
伴	伴	bø²²¹	
盤	盘	bø²²¹	
磐	磐	bø²²¹	
畔	畔	bø²²¹	
蟠	蟠	bø²²¹	
婆	婆	bø²²¹	兒化變讀 老太婆
耙	耙	bø²²¹	兒化變讀 拉草耙
叛	叛	bø¹³	
拌	拌	bø¹³	
瞞	瞒	mø²²¹	
饅	馒	mø²²¹	
鰻	鳗	mø²²¹	
幔	幔	mø²²¹	
漫	漫	mø²²¹	白讀 漫白
馬	马	mø²²¹	兒化變讀 泥馬
滿	满	mø¹³	
端	端	tø⁵³	
短	短	tø³⁵	
鍛	锻	tø⁴⁴	
斷	断	tø⁴⁴	決斷
疃	疃	tʰø⁵³	一疃路
團	团	dø²²¹	
段	段	dø¹³	
緞	缎	dø¹³	
斷	断	dø¹³	斷開
女	女	nø²²¹	兒化變讀 現作囡
囡	囡	nø²²¹	
暖	暖	nø¹³	
巒	峦	lø²²¹	
孿	孪	lø²²¹	
臠	脔	lø²²¹	
灤	滦	lø²²¹	
鸞	鸾	lø²²¹	
螺	螺	lø²²¹	兒化變讀 蜓蚰螺
裸	裸	lø²²¹	兒化變讀 赤裸
鑼	锣	lø²²¹	兒化變讀 宕鑼
亂	乱	lø¹³	
卵	卵	lø¹³	卵袋
專	专	tʃø⁵³	
磚	砖	tʃø⁵³	
詹	詹	tʃø⁵³	
瞻	瞻	tʃø⁵³	
鑽	钻	tʃø⁵³	鑽洞
轉	转	tʃø³⁵	轉變
戰	战	tʃø⁴⁴	
轉	转	tʃø⁴⁴	轉圈
鑽	钻	tʃø⁴⁴	鑽子
川	川	tʃʰø⁵³	
穿	穿	tʃʰø⁵³	
車	车	tʃʰø⁵³	兒化變讀 坐車
喘	喘	tʃʰø³⁵	
竄	窜	tʃʰø⁴⁴	
篡	篡	tʃʰø⁴⁴	
串	串	tʃʰø⁴⁴	
全	全	dʒø²²¹	
泉	泉	dʒø²²¹	
痊	痊	dʒø²²¹	
篆	篆	dʒø²²¹	
椽	椽	dʒø²²¹	
傳	传	dʒø²²¹	傳布
纏	缠	dʒø²²¹	文讀 纏足
纂	纂	dʒø¹³	
傳	传	dʒø¹³	傳念
酸	酸	ʃø⁵³	
閂	闩	ʃø⁵³	
宣	宣	ʃø⁵³	
喧	喧	ʃø⁵³	
諠	喧	ʃø⁵³	
疝	疝	ʃø⁵³	
舍	舍	ʃø⁵³	文讀 宿舍
奢	奢	ʃø³⁵	
捨	舍	ʃø³⁵	文讀 捨去
算	算	ʃø⁴⁴	
蒜	蒜	ʃø⁴⁴	
船	船	ʒø²²¹	
蟾	蟾	ʒø²²¹	
纏	缠	ʒø²²¹	文讀 盤纏
善	善	ʒø¹³	
羨	羡	ʒø¹³	
然	然	ʒø¹³	
燃	燃	ʒø¹³	
繕	缮	ʒø¹³	
膳	膳	ʒø¹³	
蟬	蝉	ʒø¹³	
旋	旋	ʒø¹³	
擅	擅	ʒø¹³	
禪	禅	ʒø¹³	
單	单	ʒø¹³	姓
鵝	鹅	ŋø²²¹	兒化變讀 雁鵝
芽	芽	ŋø²²¹	兒化變讀 綠豆芽
蝦	虾	hø⁵³	兒化變讀
鴉	鸦	ø⁵³	兒化變讀 火老鴉
鵶	鸦	ø⁵³	兒化變讀 火老鵶
官	官	kuø⁵³	
棺	棺	kuø⁵³	
觀	观	kuø⁵³	觀看
脘	脘	kuø⁵³	胸脘頭
管	管	kuø³⁵	
倌	倌	kuø³⁵	
館	馆	kuø³⁵	
果	果	kuø³⁵	兒化變讀 祭竈果
哥	哥	kuø³⁵	兒化變讀 阿哥
瓜	瓜	kuø³⁵	兒化變讀 黃金瓜
冠	冠	kuø⁴⁴	
灌	灌	kuø⁴⁴	
罐	罐	kuø⁴⁴	
貫	贯	kuø⁴⁴	
觀	观	kuø⁴⁴	寺觀
寬	宽	kʰuø⁵³	
款	款	kʰuø³⁵	
歡	欢	huø⁵³	
瘓	痪	huø⁵³	
渙	涣	huø⁵³	
奐	奂	huø⁵³	
花	花	huø⁵³	兒化變讀 奶花 嬰兒
喚	唤	huø⁴⁴	
煥	焕	huø⁴⁴	
桓	桓	ɦuø²²¹	
垣	垣	ɦuø²²¹	
援	援	ɦuø²²¹	
完	完	ɦuø²²¹	
緩	缓	ɦuø¹³	
換	换	ɦuø¹³	
丸	丸	ɦuø¹³	
腕	腕	uø³⁵	
豌	豌	uø³⁵	
皖	皖	uø³⁵	
碗	碗	uø³⁵	
宛	宛	uø³⁵	
婉	婉	uø³⁵	
惋	惋	uø³⁵	
捐	捐	tɕyø⁵³	
鵑	鹃	tɕyø⁵³	
娟	娟	tɕyø⁵³	
涓	涓	tɕyø⁵³	
卷	卷	tɕyø³⁵	卷簾
絹	绢	tɕyø⁴⁴	
眷	眷	tɕyø⁴⁴	
卷	卷	tɕyø⁴⁴	書卷
圈	圈	tɕʰyø⁵³	
犬	犬	tɕʰyø³⁵	
勸	劝	tɕʰyø⁴⁴	
券	券	tɕʰyø⁴⁴	
拳	拳	dʑyø²²¹	
權	权	dʑyø²²¹	
顴	颧	dʑyø²²¹	
倦	倦	dʑyø¹³	
元	元	ȵyø²²¹	
原	原	ȵyø²²¹	
源	源	ȵyø²²¹	
阮	阮	ȵyø²²¹	姓
願	愿	ȵyø¹³	
軟	软	ȵyø¹³	文讀
楦	楦	ɕyø⁵³	鞋楦
袁	袁	ɦyø²²¹	
轅	辕	ɦyø²²¹	
圓	圆	ɦyø²²¹	
園	园	ɦyø²²¹	
員	员	ɦyø²²¹	
猿	猿	ɦyø²²¹	
緣	缘	ɦyø²²¹	
眩	眩	ɦyø²²¹	
玄	玄	ɦyø²²¹	
懸	悬	ɦyø²²¹	
援	援	ɦyø²²¹	
遠	远	ɦyø¹³	
縣	县	ɦyø¹³	
院	院	ɦyø¹³	
丸	丸	ɦyø¹³	
冤	冤	yø⁵³	
淵	渊	yø⁵³	
渕	渊	yø⁵³	
怨	怨	yø⁴⁴	
鴛	鸳	yø⁴⁴	
波	波	paʊ⁵³	
菠	菠	paʊ⁵³	
玻	玻	paʊ⁵³	
播	播	paʊ⁴⁴	
簸	簸	paʊ⁴⁴	
坡	坡	pʰaʊ⁵³	
頗	颇	pʰaʊ⁵³	
剖	剖	pʰaʊ⁵³	
破	破	pʰaʊ⁴⁴	
婆	婆	baʊ²²¹	
縛	缚	baʊ¹³	白讀
薄	薄	baʊ¹³	薄荷
模	模	maʊ²²¹	
蟆	蟆	maʊ²²¹	
慕	慕	maʊ²²¹	
驀	蓦	maʊ²²¹	
摩	摩	maʊ²²¹	
魔	魔	maʊ²²¹	
磨	磨	maʊ²²¹	磨刀
暮	暮	maʊ¹³	
幕	幕	maʊ¹³	
墓	墓	maʊ¹³	
募	募	maʊ¹³	
磨	磨	maʊ¹³	石磨
某	某	maʊ¹³	
多	多	taʊ⁵³	
拖	拖	tʰaʊ⁵³	
妥	妥	tʰaʊ³⁵	
橢	椭	tʰaʊ³⁵	
馱	驮	daʊ²²¹	
駝	驼	daʊ²²¹	
惰	惰	daʊ²²¹	
墮	堕	daʊ²²¹	
舵	舵	daʊ¹³	
大	大	daʊ¹³	白讀
糯	糯	naʊ²²¹	
懦	懦	naʊ²²¹	
螺	螺	laʊ²²¹	
騾	骡	laʊ²²¹	
卵	卵	laʊ²²¹	
裸	裸	laʊ²²¹	
羅	罗	laʊ²²¹	
邏	逻	laʊ²²¹	
籮	箩	laʊ²²¹	
鑼	锣	laʊ²²¹	
虜	虏	laʊ²²¹	
蘿	萝	laʊ²²¹	文讀
腡	脶	laʊ²²¹	手指腡
擄	掳	laʊ¹³	
摟	搂	laʊ¹³	摟錢
摟	搂	ʔlaʊ⁴⁴	抱嬰兒
做	做	tsaʊ⁵³	
左	左	tsaʊ³⁵	
佐	佐	tsaʊ³⁵	
錯	错	tsʰaʊ⁵³	
搓	搓	tsʰaʊ⁵³	
挫	挫	tsʰaʊ⁵³	
銼	锉	tsʰaʊ⁵³	
梭	梭	saʊ⁵³	
唆	唆	saʊ⁵³	
啥	啥	saʊ⁵³	什麼
鎖	锁	saʊ³⁵	
瑣	琐	saʊ³⁵	
座	座	zaʊ²²¹	
坐	坐	zaʊ²²¹	
歌	歌	kaʊ⁵³	
哥	哥	kaʊ⁵³	
戈	戈	kaʊ⁵³	
個	个	kaʊ⁵³	幾個
鍋	锅	kaʊ³⁵	
果	果	kaʊ³⁵	
裹	裹	kaʊ³⁵	
蝸	蜗	kaʊ³⁵	
過	过	kaʊ⁴⁴	
個	个	kaʊ⁴⁴	個子頭
科	科	kʰaʊ⁵³	
窠	窠	kʰaʊ⁵³	
苛	苛	kʰaʊ⁵³	
可	可	kʰaʊ³⁵	
顆	颗	kʰaʊ³⁵	
棵	棵	kʰaʊ³⁵	
課	课	kʰaʊ⁴⁴	
俄	俄	ŋaʊ²²¹	
娥	娥	ŋaʊ²²¹	
鵝	鹅	ŋaʊ¹³	
餓	饿	ŋaʊ¹³	
臥	卧	ŋaʊ¹³	
火	火	haʊ³⁵	
夥	伙	haʊ³⁵	
伙	伙	haʊ³⁵	
荷	荷	haʊ³⁵	薄荷
貨	货	haʊ⁴⁴	
和	和	ɦaʊ²²¹	
禾	禾	ɦaʊ²²¹	
河	河	ɦaʊ²²¹	
何	何	ɦaʊ²²¹	
荷	荷	ɦaʊ²²¹	荷花
禍	祸	ɦaʊ¹³	
賀	贺	ɦaʊ¹³	
倭	倭	aʊ⁵³	
渦	涡	aʊ⁵³	
阿	阿	aʊ⁵³	阿膠
碑	碑	pᴇɪ⁵³	
悲	悲	pᴇɪ⁵³	
卑	卑	pᴇɪ⁵³	
彼	彼	pᴇɪ⁵³	
貝	贝	pᴇɪ⁵³	
狽	狈	pᴇɪ⁵³	
褙	褙	pᴇɪ⁵³	
杯	杯	pᴇɪ⁵³	
褒	褒	pᴇɪ⁵³	
揹	背	pᴇɪ⁵³	揹負
輩	辈	pᴇɪ⁴⁴	
背	背	pᴇɪ⁴⁴	背脊
胚	胚	pʰᴇɪ⁵³	
坯	坯	pʰᴇɪ⁵³	
丕	丕	pʰᴇɪ⁵³	
轡	辔	pʰᴇɪ⁵³	
呸	呸	pʰᴇɪ⁵³	
沛	沛	pʰᴇɪ⁴⁴	
配	配	pʰᴇɪ⁴⁴	
培	培	bᴇɪ²²¹	
陪	陪	bᴇɪ²²¹	
賠	赔	bᴇɪ²²¹	
倍	倍	bᴇɪ¹³	
佩	佩	bᴇɪ¹³	
焙	焙	bᴇɪ¹³	
備	备	bᴇɪ¹³	
悖	悖	bᴇɪ¹³	悖時
裴	裴	bᴇɪ¹³	姓
背	背	bᴇɪ¹³	背誦
被	被	bᴇɪ¹³	被迫
梅	梅	mᴇɪ²²¹	
枚	枚	mᴇɪ²²¹	
媒	媒	mᴇɪ²²¹	
謀	谋	mᴇɪ²²¹	
玫	玫	mᴇɪ²²¹	
牟	牟	mᴇɪ²²¹	
煤	煤	mᴇɪ²²¹	
楣	楣	mᴇɪ²²¹	
媚	媚	mᴇɪ²²¹	
貿	贸	mᴇɪ²²¹	
寐	寐	mᴇɪ²²¹	
眉	眉	mᴇɪ²²¹	
謎	谜	mᴇɪ²²¹	白讀
畝	亩	mᴇɪ²²¹	文讀
黴	霉	mᴇɪ²²¹	黴天
霉	霉	mᴇɪ²²¹	霉天
每	每	mᴇɪ¹³	
美	美	mᴇɪ¹³	
牡	牡	mᴇɪ¹³	
茂	茂	mᴇɪ¹³	
昧	昧	mᴇɪ¹³	
母	母	mᴇɪ¹³	
黴	霉	mᴇɪ¹³	黴麩
霉	霉	mᴇɪ¹³	霉麩
妹	妹	mᴇɪ¹³	阿妹
妹	妹	ʔmᴇɪ⁴⁴	妹妹
否	否	fᴇɪ³⁵	
負	负	vᴇɪ²²¹	
阜	阜	vᴇɪ²²¹	
浮	浮	vᴇɪ²²¹	文讀
𣍐	𠊉	vᴇɪ¹³	勿會
堆	堆	tᴇɪ⁵³	
兜	兜	tᴇɪ⁵³	
𠡒	𠡒	tᴇɪ⁵³	拉扯，𠡒百筋
抖	抖	tᴇɪ³⁵	
陡	陡	tᴇɪ³⁵	文讀
斗	斗	tᴇɪ³⁵	升斗
對	对	tᴇɪ⁴⁴	
鬥	斗	tᴇɪ⁴⁴	鬥爭
推	推	tʰᴇɪ⁵³	
偷	偷	tʰᴇɪ⁵³	
貪	贪	tʰᴇɪ⁵³	
腿	腿	tʰᴇɪ³⁵	
敨	敨	tʰᴇɪ³⁵	敨開
退	退	tʰᴇɪ⁴⁴	
透	透	tʰᴇɪ⁴⁴	
探	探	tʰᴇɪ⁴⁴	
蛻	蜕	tʰᴇɪ⁴⁴	
蜕	蜕	tʰᴇɪ⁴⁴	
頭	头	dᴇɪ²²¹	
投	投	dᴇɪ²²¹	
頹	颓	dᴇɪ²²¹	
潭	潭	dᴇɪ²²¹	白讀 水淌潭
墜	坠	dᴇɪ¹³	墜肚
隊	队	dᴇɪ¹³	
豆	豆	dᴇɪ¹³	
逗	逗	dᴇɪ¹³	
兌	兑	dᴇɪ¹³	
兑	兑	dᴇɪ¹³	
骰	骰	dᴇɪ¹³	
痘	痘	dᴇɪ¹³	
南	南	nᴇɪ²²¹	
男	男	nᴇɪ²²¹	
內	内	nᴇɪ¹³	
軟	软	nᴇɪ¹³	白讀
雷	雷	lᴇɪ²²¹	
樓	楼	lᴇɪ²²¹	
蕾	蕾	lᴇɪ²²¹	
髏	髅	lᴇɪ²²¹	
儡	儡	lᴇɪ²²¹	
了	了	lᴇɪ²²¹	算了
淚	泪	lᴇɪ²²¹	文讀
累	累	lᴇɪ¹³	
壘	垒	lᴇɪ¹³	
類	类	lᴇɪ¹³	
磊	磊	lᴇɪ¹³	
擂	擂	lᴇɪ¹³	
簍	篓	lᴇɪ¹³	
屢	屡	lᴇɪ¹³	
漏	漏	lᴇɪ¹³	
陋	陋	lᴇɪ¹³	
鄒	邹	tsᴇɪ⁵³	姓
追	追	tsᴇɪ⁵³	文讀
錐	锥	tsᴇɪ⁵³	文讀
走	走	tsᴇɪ³⁵	
最	最	tsᴇɪ⁴⁴	
醉	醉	tsᴇɪ⁴⁴	
奏	奏	tsᴇɪ⁴⁴	
贅	赘	tsᴇɪ⁴⁴	
綴	缀	tsᴇɪ⁴⁴	
皺	皱	tsᴇɪ⁴⁴	
縐	绉	tsᴇɪ⁴⁴	
催	催	tsʰᴇɪ⁵³	
炊	炊	tsʰᴇɪ⁵³	
瘁	瘁	tsʰᴇɪ⁵³	
崔	崔	tsʰᴇɪ⁵³	姓
吹	吹	tsʰᴇɪ⁵³	文讀
翠	翠	tsʰᴇɪ⁴⁴	
摧	摧	tsʰᴇɪ⁴⁴	
脆	脆	tsʰᴇɪ⁴⁴	
湊	凑	tsʰᴇɪ⁴⁴	
驟	骤	dzᴇɪ¹³	
槌	槌	dzᴇɪ¹³	文讀
雖	虽	sᴇɪ⁵³	
水	水	sᴇɪ³⁵	文讀
尿	尿	sᴇɪ³⁵	文讀
碎	碎	sᴇɪ⁴⁴	
嗽	嗽	sᴇɪ⁴⁴	
綏	绥	sᴇɪ⁴⁴	
稅	税	sᴇɪ⁴⁴	
税	税	sᴇɪ⁴⁴	
搜	搜	sᴇɪ⁴⁴	
餿	馊	sᴇɪ⁴⁴	
瘦	瘦	sᴇɪ⁴⁴	
祟	祟	sᴇɪ⁴⁴	
颼	飕	sᴇɪ⁴⁴	
艘	艘	sᴇɪ⁴⁴	
叟	叟	sᴇɪ⁴⁴	
歲	岁	sᴇɪ⁴⁴	文讀
愁	愁	zᴇɪ²²¹	
銳	锐	zᴇɪ²²¹	
鋭	锐	zᴇɪ²²¹	
睡	睡	zᴇɪ²²¹	
遂	遂	zᴇɪ²²¹	
穗	穗	zᴇɪ²²¹	
隨	随	zᴇɪ²²¹	
隧	隧	zᴇɪ²²¹	
蕊	蕊	zᴇɪ²²¹	文讀
誰	谁	zᴇɪ²²¹	文讀
垂	垂	zᴇɪ²²¹	文讀
錘	锤	zᴇɪ²²¹	文讀
捶	捶	zᴇɪ²²¹	文讀
隋	隋	zᴇɪ¹³	
瑞	瑞	zᴇɪ¹³	
罪	罪	zᴇɪ¹³	
蠶	蚕	zᴇɪ¹³	
粹	粹	zᴇɪ¹³	
勾	勾	kᴇɪ⁵³	
鉤	钩	kᴇɪ⁵³	
溝	沟	kᴇɪ⁵³	
狗	狗	kᴇɪ³⁵	
苟	苟	kᴇɪ³⁵	
夠	够	kᴇɪ⁴⁴	
够	够	kᴇɪ⁴⁴	
構	构	kᴇɪ⁴⁴	
購	购	kᴇɪ⁴⁴	
媾	媾	kᴇɪ⁴⁴	
口	口	kʰᴇɪ³⁵	
扣	扣	kʰᴇɪ⁴⁴	
寇	寇	kʰᴇɪ⁴⁴	
蔻	蔻	kʰᴇɪ⁴⁴	
叩	叩	kʰᴇɪ⁴⁴	
跔	跔	ɡᴇɪ²²¹	收縮
抅	抅	ɡᴇɪ¹³	頭部伏案臂上
牛	牛	ŋᴇɪ²²¹	白讀
偶	偶	ŋᴇɪ¹³	
藕	藕	ŋᴇɪ¹³	
耦	耦	ŋᴇɪ¹³	
隅	隅	ŋᴇɪ¹³	
憨	憨	hᴇɪ⁵³	
酣	酣	hᴇɪ⁵³	
鱟	鲎	hᴇɪ⁵³	虹
蚶	蚶	hᴇɪ⁵³	蚶子
鼾	鼾	hᴇɪ³⁵	
吼	吼	hᴇɪ³⁵	
漢	汉	hᴇɪ⁴⁴	
罕	罕	hᴇɪ⁴⁴	
含	含	ɦᴇɪ²²¹	
函	函	ɦᴇɪ²²¹	
寒	寒	ɦᴇɪ²²¹	
旱	旱	ɦᴇɪ²²¹	
侯	侯	ɦᴇɪ²²¹	
猴	猴	ɦᴇɪ²²¹	
涵	涵	ɦᴇɪ²²¹	
憾	憾	ɦᴇɪ²²¹	
撼	撼	ɦᴇɪ²²¹	
悍	悍	ɦᴇɪ²²¹	
捍	捍	ɦᴇɪ²²¹	
喉	喉	ɦᴇɪ²²¹	
韓	韩	ɦᴇɪ¹³	姓
汗	汗	ɦᴇɪ¹³	
焊	焊	ɦᴇɪ¹³	
翰	翰	ɦᴇɪ¹³	
後	后	ɦᴇɪ¹³	
候	候	ɦᴇɪ¹³	
厚	厚	ɦᴇɪ¹³	
庵	庵	ᴇɪ⁵³	
暗	暗	ᴇɪ⁵³	
安	安	ᴇɪ⁵³	
鞍	鞍	ᴇɪ⁵³	
歐	欧	ᴇɪ⁵³	
甌	瓯	ᴇɪ⁵³	
嘔	呕	ᴇɪ⁵³	
毆	殴	ᴇɪ⁵³	
鷗	鸥	ᴇɪ⁵³	
謳	讴	ᴇɪ⁵³	
暗	暗	ᴇɪ⁴⁴	
按	按	ᴇɪ⁴⁴	
案	案	ᴇɪ⁴⁴	
圭	圭	kuᴇɪ⁵³	
閨	闺	kuᴇɪ⁵³	
規	规	kuᴇɪ⁵³	
軌	轨	kuᴇɪ⁵³	
癸	癸	kuᴇɪ⁵³	
葵	葵	kuᴇɪ⁵³	
歸	归	kuᴇɪ⁵³	文讀
龜	龟	kuᴇɪ⁵³	文讀
詭	诡	kuᴇɪ³⁵	
鬼	鬼	kuᴇɪ³⁵	文讀
儈	侩	kuᴇɪ⁴⁴	
劊	刽	kuᴇɪ⁴⁴	
檜	桧	kuᴇɪ⁴⁴	
桂	桂	kuᴇɪ⁴⁴	
鱖	鳜	kuᴇɪ⁴⁴	
貴	贵	kuᴇɪ⁴⁴	文讀
會	会	kuᴇɪ⁴⁴	會計
奎	奎	kʰuᴇɪ⁵³	
傀	傀	kʰuᴇɪ⁵³	
魁	魁	kʰuᴇɪ⁵³	
盔	盔	kʰuᴇɪ⁵³	
塊	块	kʰuᴇɪ⁵³	
虧	亏	kʰuᴇɪ⁵³	文讀
⿰米鬼	⿰米鬼	kʰuᴇɪ⁴⁴	
愧	愧	kʰuᴇɪ⁴⁴	
逵	逵	ɡuᴇɪ²²¹	
窺	窥	ɡuᴇɪ¹³	
饋	馈	ɡuᴇɪ¹³	
跪	跪	ɡuᴇɪ¹³	文讀
櫃	柜	ɡuᴇɪ¹³	文讀
潰	溃	ɡuᴇɪ¹³	潰敗
恢	恢	huᴇɪ⁵³	
灰	灰	huᴇɪ⁵³	
揮	挥	huᴇɪ⁵³	
輝	辉	huᴇɪ⁵³	
徽	徽	huᴇɪ⁵³	
賄	贿	huᴇɪ⁵³	
卉	卉	huᴇɪ⁵³	
麾	麾	huᴇɪ⁵³	
詼	诙	huᴇɪ⁵³	
悔	悔	huᴇɪ⁴⁴	
諱	讳	huᴇɪ⁴⁴	
毀	毁	huᴇɪ⁴⁴	
晦	晦	huᴇɪ⁴⁴	
誨	诲	huᴇɪ⁴⁴	
桅	桅	ɦuᴇɪ²²¹	
回	回	ɦuᴇɪ²²¹	
茴	茴	ɦuᴇɪ²²¹	
蛔	蛔	ɦuᴇɪ²²¹	
惠	惠	ɦuᴇɪ²²¹	
慧	慧	ɦuᴇɪ²²¹	
彗	彗	ɦuᴇɪ²²¹	
圍	围	ɦuᴇɪ²²¹	文讀
槐	槐	ɦuᴇɪ²²¹	
違	违	ɦuᴇɪ¹³	
危	危	ɦuᴇɪ¹³	
彙	汇	ɦuᴇɪ¹³	
匯	汇	ɦuᴇɪ¹³	
偉	伟	ɦuᴇɪ¹³	
韋	韦	ɦuᴇɪ¹³	
葦	苇	ɦuᴇɪ¹³	
繪	绘	ɦuᴇɪ¹³	
魏	魏	ɦuᴇɪ¹³	
緯	纬	ɦuᴇɪ¹³	
胃	胃	ɦuᴇɪ¹³	
謂	谓	ɦuᴇɪ¹³	
位	位	ɦuᴇɪ¹³	
僞	伪	ɦuᴇɪ¹³	
偽	伪	ɦuᴇɪ¹³	
衛	卫	ɦuᴇɪ¹³	
蝟	猬	ɦuᴇɪ¹³	
爲	为	ɦuᴇɪ¹³	
為	为	ɦuᴇɪ¹³	
會	会	ɦuᴇɪ¹³	開會
煨	煨	uᴇɪ⁵³	
威	威	uᴇɪ⁵³	
萎	萎	uᴇɪ⁵³	
委	委	uᴇɪ³⁵	
畏	畏	uᴇɪ⁴⁴	
慰	慰	uᴇɪ⁴⁴	
穢	秽	uᴇɪ⁴⁴	
諉	诿	uᴇɪ⁴⁴	
尉	尉	uᴇɪ⁴⁴	
喂	喂	uᴇɪ⁴⁴	文讀 喂飯
謬	谬	miu²²¹	
丟	丢	tiu⁵³	
劉	刘	liu²²¹	
流	流	liu²²¹	
留	留	liu²²¹	
榴	榴	liu²²¹	
硫	硫	liu²²¹	
琉	琉	liu²²¹	
瘤	瘤	liu²²¹	
柳	柳	liu²²¹	
餾	馏	liu²²¹	
溜	溜	liu¹³	
周	周	tɕiu⁵³	
舟	舟	tɕiu⁵³	
州	州	tɕiu⁵³	
洲	洲	tɕiu⁵³	
糾	纠	tɕiu⁵³	
鳩	鸠	tɕiu⁵³	
肘	肘	tɕiu³⁵	
帚	帚	tɕiu³⁵	
酒	酒	tɕiu³⁵	
九	九	tɕiu³⁵	
久	久	tɕiu³⁵	
韭	韭	tɕiu³⁵	
晝	昼	tɕiu⁴⁴	
咒	咒	tɕiu⁴⁴	
救	救	tɕiu⁴⁴	
究	究	tɕiu⁴⁴	
灸	灸	tɕiu⁴⁴	
疚	疚	tɕiu⁴⁴	
柩	柩	tɕiu⁴⁴	
秋	秋	tɕʰiu⁵³	
丘	丘	tɕʰiu⁵³	
抽	抽	tɕʰiu⁵³	
邱	邱	tɕʰiu⁵³	
蚯	蚯	tɕʰiu⁵³	
鰍	鳅	tɕʰiu⁵³	
湫	湫	tɕʰiu⁵³	
醜	丑	tɕʰiu³⁵	
臭	臭	tɕʰiu⁴⁴	
綢	绸	dʑiu²²¹	
籌	筹	dʑiu²²¹	
仇	仇	dʑiu²²¹	
酬	酬	dʑiu²²¹	
柔	柔	dʑiu²²¹	
求	求	dʑiu²²¹	
球	球	dʑiu²²¹	
紂	纣	dʑiu²²¹	
宙	宙	dʑiu²²¹	
囚	囚	dʑiu²²¹	
泅	泅	dʑiu²²¹	
稠	稠	dʑiu²²¹	
售	售	dʑiu²²¹	
舅	舅	dʑiu¹³	
臼	臼	dʑiu¹³	
舊	旧	dʑiu¹³	
就	就	dʑiu¹³	文讀
牛	牛	ȵiu²²¹	文讀
紐	纽	ȵiu¹³	
扭	扭	ȵiu¹³	
鈕	钮	ȵiu¹³	
羞	羞	ɕiu⁵³	
修	修	ɕiu⁵³	
休	休	ɕiu⁵³	
收	收	ɕiu⁵³	
朽	朽	ɕiu⁵³	
首	首	ɕiu³⁵	
手	手	ɕiu³⁵	
守	守	ɕiu³⁵	
秀	秀	ɕiu⁴⁴	
獸	兽	ɕiu⁴⁴	
鏽	锈	ɕiu⁴⁴	
銹	锈	ɕiu⁴⁴	
繡	绣	ɕiu⁴⁴	
綉	绣	ɕiu⁴⁴	
宿	宿	ɕiu⁴⁴	星宿
授	授	ʑiu¹³	
受	受	ʑiu¹³	
袖	袖	ʑiu¹³	
壽	寿	ʑiu¹³	
就	就	ʑiu¹³	白讀
尤	尤	ɦiu²²¹	
由	由	ɦiu²²¹	
郵	邮	ɦiu²²¹	
油	油	ɦiu²²¹	
遊	游	ɦiu²²¹	
猶	犹	ɦiu²²¹	
酉	酉	ɦiu²²¹	
酋	酋	ɦiu²²¹	
右	右	ɦiu¹³	
有	有	ɦiu¹³	
友	友	ɦiu¹³	
釉	釉	ɦiu¹³	
誘	诱	ɦiu¹³	
又	又	ɦiu¹³	文讀
憂	忧	iu⁵³	
優	优	iu⁵³	
悠	悠	iu⁵³	
幽	幽	iu⁵³	
幼	幼	iu⁵³	
鞭	鞭	piɪ⁵³	
編	编	piɪ⁵³	
邊	边	piɪ⁵³	
蝙	蝙	piɪ⁵³	
貶	贬	piɪ³⁵	
砭	砭	piɪ³⁵	
扁	扁	piɪ³⁵	
匾	匾	piɪ³⁵	
變	变	piɪ⁴⁴	
遍	遍	piɪ⁴⁴	
篇	篇	pʰiɪ⁵³	
偏	偏	pʰiɪ⁵³	
翩	翩	pʰiɪ⁵³	
騙	骗	pʰiɪ⁴⁴	
片	片	pʰiɪ⁴⁴	
緶	缏	biɪ²²¹	一種針法
便	便	biɪ²²¹	便宜
辨	辨	biɪ¹³	
辯	辩	biɪ¹³	
辮	辫	biɪ¹³	
卞	卞	biɪ¹³	
汴	汴	biɪ¹³	
便	便	biɪ¹³	便當
綿	绵	miɪ²²¹	
棉	棉	miɪ²²¹	
眠	眠	miɪ²²¹	
免	免	miɪ¹³	
勉	勉	miɪ¹³	
娩	娩	miɪ¹³	
緬	缅	miɪ¹³	
面	面	miɪ¹³	
麪	面	miɪ¹³	
麵	面	miɪ¹³	
顛	颠	tiɪ⁵³	
巔	巅	tiɪ⁵³	
癲	癫	tiɪ⁵³	
踮	踮	tiɪ⁵³	
惦	惦	tiɪ⁵³	
掂	掂	tiɪ⁵³	
點	点	tiɪ³⁵	
典	典	tiɪ³⁵	
碘	碘	tiɪ³⁵	
店	店	tiɪ⁴⁴	
天	天	tʰiɪ⁵³	
添	添	tʰiɪ⁵³	
舔	舔	tʰiɪ³⁵	
掭	掭	tʰiɪ³⁵	掭燈芯
甜	甜	diɪ²²¹	
田	田	diɪ²²¹	
填	填	diɪ²²¹	
奠	奠	diɪ²²¹	
佃	佃	diɪ²²¹	
鈿	钿	diɪ²²¹	銅鈿
甸	甸	diɪ²²¹	
澱	淀	diɪ²²¹	
電	电	diɪ¹³	
殿	殿	diɪ¹³	
墊	垫	diɪ¹³	
簟	簟	diɪ¹³	篾簟
滇	滇	diɪ¹³	
廉	廉	liɪ²²¹	
鐮	镰	liɪ²²¹	
簾	帘	liɪ²²¹	
連	连	liɪ²²¹	
聯	联	liɪ²²¹	
憐	怜	liɪ²²¹	
蓮	莲	liɪ²²¹	
戀	恋	liɪ²²¹	
鏈	链	liɪ¹³	
殮	殓	liɪ¹³	
練	练	liɪ¹³	
煉	炼	liɪ¹³	
臉	脸	liɪ¹³	
斂	敛	liɪ¹³	
鑑	鉴	tɕiɪ⁵³	
尖	尖	tɕiɪ⁵³	
沾	沾	tɕiɪ⁵³	
瞻	瞻	tɕiɪ⁵³	
兼	兼	tɕiɪ⁵³	
艱	艰	tɕiɪ⁵³	
煎	煎	tɕiɪ⁵³	
展	展	tɕiɪ⁵³	
餞	饯	tɕiɪ⁵³	
肩	肩	tɕiɪ⁵³	
輾	辗	tɕiɪ⁵³	
氈	毡	tɕiɪ⁵³	
堅	坚	tɕiɪ⁵³	
柬	柬	tɕiɪ⁵³	文讀
檢	检	tɕiɪ³⁵	
簡	简	tɕiɪ³⁵	
繭	茧	tɕiɪ³⁵	
剪	剪	tɕiɪ³⁵	
佔	占	tɕiɪ⁴⁴	
劍	剑	tɕiɪ⁴⁴	
澗	涧	tɕiɪ⁴⁴	
建	建	tɕiɪ⁴⁴	
鐗	锏	tɕiɪ⁴⁴	
鐧	锏	tɕiɪ⁴⁴	
顫	颤	tɕiɪ⁴⁴	
薦	荐	tɕiɪ⁴⁴	
箭	箭	tɕiɪ⁴⁴	
間	间	tɕiɪ⁴⁴	文讀
諫	谏	tɕiɪ⁴⁴	文讀
殲	歼	tɕʰiɪ⁵³	
籤	签	tɕʰiɪ⁵³	
謙	谦	tɕʰiɪ⁵³	
遷	迁	tɕʰiɪ⁵³	
遣	遣	tɕʰiɪ⁵³	
箋	笺	tɕʰiɪ⁵³	
千	千	tɕʰiɪ⁵³	
牽	牵	tɕʰiɪ⁵³	
淺	浅	tɕʰiɪ³⁵	
欠	欠	tɕʰiɪ⁴⁴	
歉	歉	tɕʰiɪ⁴⁴	
縴	纤	tɕʰiɪ⁴⁴	拉縴
潛	潜	dʑiɪ²²¹	
鉗	钳	dʑiɪ²²¹	
錢	钱	dʑiɪ²²¹	
件	件	dʑiɪ²²¹	
乾	乾	dʑiɪ²²¹	
掮	掮	dʑiɪ²²¹	
鍵	键	dʑiɪ²²¹	
虔	虔	dʑiɪ²²¹	
纏	缠	dʑiɪ²²¹	白讀 纏腳
漸	渐	dʑiɪ¹³	
儉	俭	dʑiɪ¹³	
健	健	dʑiɪ¹³	
踐	践	dʑiɪ¹³	
黔	黔	dʑiɪ¹³	
閻	阎	ȵiɪ²²¹	
嚴	严	ȵiɪ²²¹	
鮎	鲇	ȵiɪ²²¹	
彥	彦	ȵiɪ²²¹	
諺	谚	ȵiɪ²²¹	
年	年	ȵiɪ²²¹	
儼	俨	ȵiɪ²²¹	
研	研	ȵiɪ²²¹	
粘	粘	ȵiɪ¹³	粘頭樹
染	染	ȵiɪ¹³	
碾	碾	ȵiɪ¹³	
釅	酽	ȵiɪ¹³	上釅（癮）
硯	砚	ȵiɪ¹³	
閃	闪	ɕiɪ⁵³	
仙	仙	ɕiɪ⁵³	
鮮	鲜	ɕiɪ⁵³	
掀	掀	ɕiɪ⁵³	
先	先	ɕiɪ⁵³	
軒	轩	ɕiɪ⁵³	
秈	籼	ɕiɪ⁵³	
腺	腺	ɕiɪ⁵³	
煽	煽	ɕiɪ⁵³	
纖	纤	ɕiɪ⁵³	纖維
騸	骟	ɕiɪ⁵³	閹割
杴	杴	ɕiɪ⁵³	㽘泥杴
顯	显	ɕiɪ³⁵	
險	险	ɕiɪ³⁵	
癬	癣	ɕiɪ³⁵	
陝	陕	ɕiɪ³⁵	
筅	筅	ɕiɪ³⁵	筅帚
扇	扇	ɕiɪ⁴⁴	
搧	扇	ɕiɪ⁴⁴	
線	线	ɕiɪ⁴⁴	
綫	线	ɕiɪ⁴⁴	
憲	宪	ɕiɪ⁴⁴	
獻	献	ɕiɪ⁴⁴	
前	前	ʑiɪ²²¹	
賤	贱	ʑiɪ¹³	
甘	甘	kiɪ⁵³	
柑	柑	kiɪ⁵³	
泔	泔	kiɪ⁵³	
肝	肝	kiɪ⁵³	
干	干	kiɪ⁵³	干涉
狗	狗	kiɪ⁵³	兒化變讀 黃狗
稈	秆	kiɪ³⁵	
杆	杆	kiɪ³⁵	
竿	竿	kiɪ³⁵	
趕	赶	kiɪ³⁵	
感	感	kiɪ³⁵	
敢	敢	kiɪ³⁵	
幹	干	kiɪ³⁵	幹部
看	看	kʰiɪ⁵³	
磡	磡	kʰiɪ⁵³	石磡
寋	寋	ɡiɪ²²¹	寋門
岸	岸	ŋiɪ²²¹	
炎	炎	ɦiɪ²²¹	
鹽	盐	ɦiɪ²²¹	
檐	檐	ɦiɪ²²¹	
言	言	ɦiɪ²²¹	
賢	贤	ɦiɪ²²¹	
弦	弦	ɦiɪ²²¹	
沿	沿	ɦiɪ²²¹	
豔	艳	ɦiɪ²²¹	
艷	艳	ɦiɪ²²¹	
延	延	ɦiɪ²²¹	
閒	闲	ɦiɪ²²¹	文讀
閑	闲	ɦiɪ²²¹	文讀
顏	颜	ɦiɪ²²¹	文讀
雁	雁	ɦiɪ²²¹	文讀
咸	咸	ɦiɪ²²¹	咸豐
焰	焰	ɦiɪ¹³	
演	演	ɦiɪ¹³	
醃	腌	ɦiɪ¹³	
現	现	ɦiɪ¹³	
陷	陷	ɦiɪ¹³	文讀
掩	掩	iɪ⁵³	
淹	淹	iɪ⁵³	
魘	魇	iɪ⁵³	
嫌	嫌	iɪ⁵³	
煙	烟	iɪ⁵³	
胭	胭	iɪ⁵³	
燕	燕	iɪ⁴⁴	
厭	厌	iɪ⁴⁴	
堰	堰	iɪ⁴⁴	
宴	宴	iɪ⁴⁴	
咽	咽	iɪ⁴⁴	
嚥	咽	iɪ⁴⁴	
閹	阉	iɪ⁴⁴	
晏	晏	iɪ⁴⁴	姓
浜	浜	pã⁵³	
繃	绷	pã⁵³	
綳	绷	pã⁵³	
伯	伯	pã⁵³	兒化變讀 伯伯
烹	烹	pʰã⁵³	
𥿯	𥿯	pʰã⁵³	一𥿯葡萄
朋	朋	bã²²¹	
彭	彭	bã²²¹	
膨	膨	bã²²¹	
澎	澎	bã²²¹	
棚	棚	bã²²¹	
𦗭	𦗭	bã²²¹	聾𦗭
蚌	蚌	bã¹³	
甏	甏	bã¹³	陶盛器
猛	猛	mã¹³	
孟	孟	mã¹³	
飯	饭	ʔmã⁴⁴	兒化變讀 飯飯，兒語
打	打	tã³⁵	
淌	淌	tʰã³⁵	水淌
宕	宕	dã¹³	延宕
趤	趤	dã¹³	閒逛
冷	冷	lã¹³	
爭	争	tsã⁵³	白讀
撐	撑	tsʰã⁵³	
撑	撑	tsʰã⁵³	
睜	睁	dzã²²¹	白讀
鋥	锃	dzã²²¹	鋥亮
盛	盛	dzã¹³	姓
牲	牲	sã⁵³	白讀
生	生	sã⁵³	白讀 學生
甥	甥	sã³⁵	白讀
省	省	sã³⁵	白讀 節省
聲	声	sã³⁵	白讀 輕聲
生	生	sã⁴⁴	白讀 接生
羹	羹	kã⁵³	
粳	粳	kã⁵³	
埂	埂	kã⁵³	
耿	耿	kã⁵³	
更	更	kã⁵³	白讀
庚	庚	kã⁵³	白讀
耕	耕	kã⁵³	白讀
梗	梗	kã⁵³	白讀
坑	坑	kʰã⁵³	
鯁	鲠	ɡã¹³	
硬	硬	ŋã¹³	
亨	亨	hã⁵³	
夯	夯	hã⁴⁴	
行	行	ɦã²²¹	白讀 行爲
桁	桁	ɦã²²¹	桁條
杏	杏	ɦã¹³	
櫻	樱	ã⁵³	白讀 櫻桃
鸚	鹦	ã⁵³	白讀 鸚哥
㹙	㹙	ã⁴⁴	小牛㹙
良	良	liã²²¹	
涼	凉	liã²²¹	
糧	粮	liã²²¹	
樑	梁	liã²²¹	
梁	梁	liã²²¹	
粱	粱	liã²²¹	
諒	谅	liã²²¹	
輛	辆	liã²²¹	
量	量	liã²²¹	量米
兩	两	liã²²¹	斤兩
亮	亮	liã¹³	文讀
量	量	liã¹³	氣量
兩	两	liã¹³	兩個
疆	疆	tɕiã⁵³	
張	张	tɕiã⁵³	
僵	僵	tɕiã⁵³	
蔣	蒋	tɕiã⁵³	
將	将	tɕiã⁵³	將來
腳	脚	tɕiã⁵³	兒化變讀 拐腳
雀	雀	tɕiã⁵³	兒化變讀 麻雀
漲	涨	tɕiã³⁵	
獎	奖	tɕiã³⁵	
槳	桨	tɕiã³⁵	
長	长	tɕiã³⁵	生長
姜	姜	tɕiã⁴⁴	
醬	酱	tɕiã⁴⁴	
漿	浆	tɕiã⁴⁴	
帳	帐	tɕiã⁴⁴	
賬	账	tɕiã⁴⁴	
脹	胀	tɕiã⁴⁴	
仗	仗	tɕiã⁴⁴	打仗
將	将	tɕiã⁴⁴	將軍
槍	枪	tɕʰiã⁵³	
腔	腔	tɕʰiã⁵³	
羌	羌	tɕʰiã⁵³	
敞	敞	tɕʰiã⁵³	
強	强	tɕʰiã⁵³	勉強
强	强	tɕʰiã⁵³	勉强
鵲	鹊	tɕʰiã⁵³	兒化變讀 鵲鴉
搶	抢	tɕʰiã³⁵	
廠	厂	tɕʰiã³⁵	
嗆	呛	tɕʰiã⁴⁴	咳嗽
𪉨	𪉨	tɕʰiã⁴⁴	𪉨蟹
詳	详	dʑiã²²¹	
祥	祥	dʑiã²²¹	
腸	肠	dʑiã²²¹	
場	场	dʑiã²²¹	
翔	翔	dʑiã²²¹	
長	长	dʑiã²²¹	長短
丈	丈	dʑiã¹³	
杖	杖	dʑiã¹³	
仗	仗	dʑiã¹³	依仗
強	强	dʑiã¹³	強大
强	强	dʑiã¹³	强大
滰	滰	dʑiã¹³	洗
娘	娘	ȵiã²²¹	
孃	娘	ȵiã²²¹	
壤	壤	ȵiã²²¹	
瓤	瓤	ȵiã²²¹	瓜瓤
央	央	ȵiã²²¹	白讀 中央
亮	亮	ȵiã²²¹	白讀 天亮
仰	仰	ȵiã¹³	
釀	酿	ȵiã¹³	
讓	让	ȵiã¹³	
攘	攘	ȵiã¹³	
箱	箱	ɕiã⁵³	
廂	厢	ɕiã⁵³	
湘	湘	ɕiã⁵³	
襄	襄	ɕiã⁵³	
鑲	镶	ɕiã⁵³	
香	香	ɕiã⁵³	
享	享	ɕiã⁵³	
鄉	乡	ɕiã⁵³	
相	相	ɕiã⁵³	相信
響	响	ɕiã¹³	
想	想	ɕiã¹³	
鯗	鲞	ɕiã¹³	
餉	饷	ɕiã⁴⁴	
向	向	ɕiã⁴⁴	
相	相	ɕiã⁴⁴	看相
商	商	ɕiã⁴⁴	白讀 商量
牆	墙	ʑiã²²¹	
墙	墙	ʑiã²²¹	
薔	蔷	ʑiã²²¹	
象	象	ʑiã¹³	
橡	橡	ʑiã¹³	
像	像	ʑiã¹³	
匠	匠	ʑiã¹³	
羊	羊	ɦiã²²¹	
洋	洋	ɦiã²²¹	
烊	烊	ɦiã²²¹	
楊	杨	ɦiã²²¹	
陽	阳	ɦiã²²¹	
揚	扬	ɦiã²²¹	
瘍	疡	ɦiã²²¹	
漾	漾	ɦiã²²¹	
養	养	ɦiã²²¹	養分
樣	样	ɦiã¹³	
癢	痒	ɦiã¹³	
鴦	鸯	iã⁵³	
映	映	iã⁵³	
央	央	iã⁵³	文讀
養	养	iã³⁵	供養
秧	秧	iã⁴⁴	
殃	殃	iã⁴⁴	
恙	恙	iã⁴⁴	安然無恙
光	光	kuã⁵³	光火
骨	骨	kuã⁵³	兒化變讀 紅腳骨
梗	梗	kuã³⁵	白讀
逛	逛	ɡuã²²¹	逛逛奔去
晃	晃	huã⁴⁴	晃來晃去
橫	横	ɦuã²²¹	橫直
撗	撗	ɦuã³⁵	撗蜘網
橫	横	uã⁴⁴	橫對
幫	帮	pɔ̃⁵³	
邦	邦	pɔ̃⁵³	
磅	磅	pɔ̃⁵³	
鎊	镑	pɔ̃⁵³	
榜	榜	pɔ̃³⁵	
綁	绑	pɔ̃³⁵	
膀	膀	pɔ̃³⁵	吊膀子
謗	谤	pɔ̃⁴⁴	
膀	膀	pʰɔ̃⁵³	大腳膀
胖	胖	pʰɔ̃⁴⁴	
旁	旁	bɔ̃²²¹	
龐	庞	bɔ̃²²¹	
滂	滂	bɔ̃²²¹	
傍	傍	bɔ̃²²¹	
膀	膀	bɔ̃²²¹	膀胱
防	防	bɔ̃¹³	
棒	棒	bɔ̃¹³	
忙	忙	mɔ̃²²¹	
芒	芒	mɔ̃²²¹	
茫	茫	mɔ̃²²¹	
盲	盲	mɔ̃²²¹	
氓	氓	mɔ̃²²¹	
懵	懵	mɔ̃¹³	
莽	莽	mɔ̃¹³	
蟒	蟒	mɔ̃¹³	
網	网	mɔ̃¹³	
夢	梦	mɔ̃¹³	
望	望	mɔ̃¹³	白讀
忘	忘	mɔ̃¹³	白讀
妄	妄	mɔ̃¹³	白讀
方	方	fɔ̃⁵³	
肪	肪	fɔ̃⁵³	
芳	芳	fɔ̃⁵³	
妨	妨	fɔ̃⁵³	
紡	纺	fɔ̃³⁵	
仿	仿	fɔ̃³⁵	
放	放	fɔ̃⁴⁴	
訪	访	fɔ̃⁴⁴	
坊	坊	fɔ̃⁴⁴	
房	房	vɔ̃²²¹	
亡	亡	vɔ̃¹³	
望	望	vɔ̃¹³	文讀
忘	忘	vɔ̃¹³	文讀
妄	妄	vɔ̃¹³	文讀
當	当	tɔ̃⁵³	當時
黨	党	tɔ̃³⁵	
檔	档	tɔ̃³⁵	
擋	挡	tɔ̃³⁵	阻擋
當	当	tɔ̃⁴⁴	上當
擋	挡	tɔ̃⁴⁴	擋扶
湯	汤	tʰɔ̃⁵³	
倘	倘	tʰɔ̃³⁵	
躺	躺	tʰɔ̃³⁵	
燙	烫	tʰɔ̃⁴⁴	
趟	趟	tʰɔ̃⁴⁴	
堂	堂	dɔ̃²²¹	
棠	棠	dɔ̃²²¹	
螳	螳	dɔ̃²²¹	
唐	唐	dɔ̃²²¹	
糖	糖	dɔ̃²²¹	
塘	塘	dɔ̃²²¹	
溏	溏	dɔ̃²²¹	爛溏
膛	膛	dɔ̃²²¹	
宕	宕	dɔ̃²²¹	石宕
蕩	荡	dɔ̃¹³	
搪	搪	dɔ̃¹³	搪瓷
囊	囊	nɔ̃²²¹	
曩	曩	nɔ̃²²¹	曩昔
攮	攮	nɔ̃²²¹	攮一刀
朗	朗	lɔ̃²²¹	
廊	廊	lɔ̃²²¹	
郎	郎	lɔ̃²²¹	
狼	狼	lɔ̃¹³	
浪	浪	lɔ̃¹³	
莊	庄	tʃɔ̃⁵³	
裝	装	tʃɔ̃⁵³	
章	章	tʃɔ̃⁵³	
樟	樟	tʃɔ̃⁵³	
樁	桩	tʃɔ̃⁵³	
掌	掌	tʃɔ̃⁵³	
贓	赃	tʃɔ̃⁵³	
髒	脏	tʃɔ̃⁵³	骯髒
葬	葬	tʃɔ̃⁴⁴	
壯	壮	tʃɔ̃⁴⁴	
障	障	tʃɔ̃⁴⁴	
倉	仓	tʃʰɔ̃⁵³	
蒼	苍	tʃʰɔ̃⁵³	
艙	舱	tʃʰɔ̃⁵³	
滄	沧	tʃʰɔ̃⁵³	
瘡	疮	tʃʰɔ̃⁵³	
昌	昌	tʃʰɔ̃⁵³	
菖	菖	tʃʰɔ̃⁵³	
窗	窗	tʃʰɔ̃⁵³	
猖	猖	tʃʰɔ̃⁵³	
創	创	tʃʰɔ̃⁵³	創傷
闖	闯	tʃʰɔ̃³⁵	
暢	畅	tʃʰɔ̃⁴⁴	
唱	唱	tʃʰɔ̃⁴⁴	
倡	倡	tʃʰɔ̃⁴⁴	
創	创	tʃʰɔ̃⁴⁴	開創
常	常	dʒɔ̃²²¹	
嘗	尝	dʒɔ̃²²¹	
償	偿	dʒɔ̃²²¹	
藏	藏	dʒɔ̃²²¹	
幢	幢	dʒɔ̃²²¹	
臟	脏	dʒɔ̃²²¹	五臟
撞	撞	dʒɔ̃¹³	
桑	桑	ʃɔ̃⁵³	
霜	霜	ʃɔ̃⁵³	
孀	孀	ʃɔ̃⁵³	
商	商	ʃɔ̃⁵³	文讀
傷	伤	ʃɔ̃⁵³	
磉	磉	ʃɔ̃⁵³	
舂	舂	ʃɔ̃⁵³	
喪	丧	ʃɔ̃⁵³	喪事
雙	双	ʃɔ̃³⁵	
爽	爽	ʃɔ̃³⁵	
嗓	嗓	ʃɔ̃³⁵	
賞	赏	ʃɔ̃³⁵	
喪	丧	ʃɔ̃⁴⁴	喪失
裳	裳	ʒɔ̃²²¹	
牀	床	ʒɔ̃²²¹	
床	床	ʒɔ̃²²¹	
上	上	ʒɔ̃¹³	
狀	状	ʒɔ̃¹³	
尚	尚	ʒɔ̃¹³	
岡	冈	kɔ̃⁵³	
崗	岗	kɔ̃⁵³	
剛	刚	kɔ̃⁵³	
綱	纲	kɔ̃⁵³	
鋼	钢	kɔ̃⁵³	
缸	缸	kɔ̃⁵³	
江	江	kɔ̃³⁵	
講	讲	kɔ̃³⁵	
港	港	kɔ̃³⁵	
槓	杠	kɔ̃⁴⁴	
杠	杠	kɔ̃⁴⁴	
扛	扛	kɔ̃⁴⁴	
肛	肛	kɔ̃⁴⁴	
降	降	kɔ̃⁴⁴	降落
亢	亢	kʰɔ̃⁵³	
康	康	kʰɔ̃⁵³	
糠	糠	kʰɔ̃⁵³	
慷	慷	kʰɔ̃⁵³	
炕	炕	kʰɔ̃⁵³	炕牀
殼	壳	kʰɔ̃⁵³	兒化變讀 礱殼（糠）
抗	抗	kʰɔ̃⁴⁴	
囥	囥	kʰɔ̃⁴⁴	藏
戇	戆	ɡɔ̃¹³	戇大
吭	吭	hɔ̃⁴⁴	油吭氣
巷	巷	ɦɔ̃²²¹	
昂	昂	ɦɔ̃²²¹	
航	航	ɦɔ̃²²¹	
杭	杭	ɦɔ̃²²¹	
降	降	ɦɔ̃²²¹	投降
行	行	ɦɔ̃²²¹	銀行
項	项	ɦɔ̃¹³	
骯	肮	ɔ̃⁵³	
肮	肮	ɔ̃⁵³	
盎	盎	ɔ̃⁵³	
光	光	kuɔ̃⁵³	辰光
廣	广	kuɔ̃³⁵	
礦	矿	kʰuɔ̃⁵³	
框	框	kʰuɔ̃⁵³	
匡	匡	kʰuɔ̃⁵³	
筐	筐	kʰuɔ̃⁵³	
眶	眶	kʰuɔ̃⁵³	
狂	狂	ɡuɔ̃¹³	
荒	荒	huɔ̃⁵³	
謊	谎	huɔ̃⁵³	
慌	慌	huɔ̃⁵³	
恍	恍	huɔ̃⁵³	
晃	晃	huɔ̃⁵³	
幌	幌	huɔ̃⁴⁴	
況	况	huɔ̃⁴⁴	
曠	旷	huɔ̃⁴⁴	
黃	黄	ɦuɔ̃²²¹	
簧	簧	ɦuɔ̃²²¹	
皇	皇	ɦuɔ̃²²¹	
蝗	蝗	ɦuɔ̃²²¹	
惶	惶	ɦuɔ̃²²¹	
王	王	ɦuɔ̃²²¹	
枉	枉	ɦuɔ̃²²¹	冤枉
旺	旺	ɦuɔ̃¹³	
汪	汪	uɔ̃⁴⁴	
往	往	uɔ̃⁴⁴	
枉	枉	uɔ̃⁴⁴	枉然
本	本	pəŋ³⁵	
奔	奔	pəŋ⁴⁴	
畚	畚	pəŋ⁴⁴	
噴	喷	pʰəŋ⁴⁴	
盆	盆	bəŋ²²¹	
笨	笨	bəŋ¹³	
門	门	məŋ²²¹	
們	们	məŋ²²¹	
萌	萌	məŋ²²¹	
蚊	蚊	məŋ²²¹	白讀
蜈	蜈	məŋ²²¹	白讀
明	明	məŋ²²¹	白讀 明份
盟	盟	məŋ²²¹	
悶	闷	məŋ¹³	
燜	焖	məŋ¹³	
聞	闻	məŋ¹³	白讀
問	问	məŋ¹³	白讀
芬	芬	fəŋ⁵³	
紛	纷	fəŋ⁵³	
吩	吩	fəŋ⁵³	
分	分	fəŋ⁵³	分別
粉	粉	fəŋ³⁵	
糞	粪	fəŋ³⁵	
奮	奋	fəŋ⁴⁴	
墳	坟	vəŋ²²¹	
文	文	vəŋ²²¹	
紋	纹	vəŋ²²¹	
氛	氛	vəŋ²²¹	
紊	紊	vəŋ²²¹	
吻	吻	vəŋ²²¹	
刎	刎	vəŋ²²¹	
蚊	蚊	vəŋ²²¹	文讀
分	分	vəŋ²²¹	安分
憤	愤	vəŋ¹³	
忿	忿	vəŋ¹³	
焚	焚	vəŋ¹³	
份	份	vəŋ¹³	
聞	闻	vəŋ¹³	文讀
問	问	vəŋ¹³	文讀
甮	甮	vəŋ¹³	勿用
登	登	təŋ⁵³	
燈	灯	təŋ⁵³	
敦	敦	təŋ⁵³	
墩	墩	təŋ⁵³	
等	等	təŋ³⁵	
躉	趸	təŋ³⁵	躉注
頂	顶	təŋ³⁵	白讀 樓頂
凳	凳	təŋ⁴⁴	
瞪	瞪	təŋ⁴⁴	
蹬	蹬	təŋ⁴⁴	
鐙	镫	təŋ⁴⁴	
頓	顿	təŋ⁴⁴	
噸	吨	təŋ⁴⁴	
燉	炖	təŋ⁴⁴	
吞	吞	tʰəŋ⁵³	
氽	氽	tʰəŋ³⁵	氽長江
褪	褪	tʰəŋ⁴⁴	褪落
騰	腾	dəŋ²²¹	
謄	誊	dəŋ²²¹	
藤	藤	dəŋ²²¹	
滕	滕	dəŋ²²¹	
屯	屯	dəŋ²²¹	
豚	豚	dəŋ²²¹	
飩	饨	dəŋ²²¹	
臀	臀	dəŋ²²¹	
囤	囤	dəŋ²²¹	
鄧	邓	dəŋ²²¹	
沌	沌	dəŋ²²¹	
盾	盾	dəŋ²²¹	
遁	遁	dəŋ²²¹	
停	停	dəŋ²²¹	白讀
鈍	钝	dəŋ¹³	
能	能	nəŋ²²¹	
寧	宁	nəŋ²²¹	白讀 寧可
嫩	嫩	nəŋ¹³	
侖	仑	ləŋ²²¹	
倫	伦	ləŋ²²¹	
淪	沦	ləŋ²²¹	
輪	轮	ləŋ²²¹	
綸	纶	ləŋ²²¹	
圇	囵	ləŋ²²¹	
棱	棱	ləŋ²²¹	
楞	楞	ləŋ²²¹	
菱	菱	ləŋ²²¹	
論	论	ləŋ¹³	
增	增	tsəŋ⁵³	
憎	憎	tsəŋ⁵³	
甑	甑	tsəŋ⁵³	陶盛器
臻	臻	tsəŋ⁵³	
尊	尊	tsəŋ⁵³	
遵	遵	tsəŋ⁵³	
撙	撙	tsəŋ⁵³	撙節
箏	筝	tsəŋ⁵³	
崢	峥	tsəŋ⁵³	
猙	狰	tsəŋ⁵³	
諍	诤	tsəŋ⁵³	
掙	挣	tsəŋ⁵³	
怎	怎	tsəŋ⁵³	文讀 怎麼
咋	咋	tsəŋ⁵³	文讀 怎麼
爭	争	tsəŋ⁵³	文讀
睜	睁	tsəŋ⁵³	文讀
曾	曾	tsəŋ⁵³	姓
村	村	tsʰəŋ⁵³	
忖	忖	tsʰəŋ³⁵	思忖
寸	寸	tsʰəŋ⁴⁴	
襯	衬	tsʰəŋ⁴⁴	
贈	赠	dzəŋ²²¹	
存	存	dzəŋ²²¹	
蹲	蹲	dzəŋ²²¹	虎蹲山
僧	僧	səŋ⁵³	
笙	笙	səŋ⁵³	
森	森	səŋ⁵³	
孫	孙	səŋ⁵³	
猻	狲	səŋ⁵³	
生	生	səŋ⁵³	文讀
牲	牲	səŋ⁵³	文讀
甥	甥	səŋ⁵³	文讀
參	参	səŋ⁵³	人參
蔘	参	səŋ⁵³	人蔘
損	损	səŋ³⁵	
省	省	səŋ³⁵	文讀 節省
滲	渗	səŋ⁴⁴	
遜	逊	səŋ⁴⁴	
層	层	zəŋ²²¹	
跟	跟	kəŋ⁵³	
根	根	kəŋ⁵³	
艮	艮	kəŋ⁵³	
耿	耿	kəŋ⁵³	
哽	哽	kəŋ⁵³	
更	更	kəŋ⁵³	文讀
梗	梗	kəŋ⁵³	文讀
庚	庚	kəŋ⁵³	文讀
耕	耕	kəŋ⁵³	文讀
鏗	铿	kʰəŋ⁵³	
肯	肯	kʰəŋ³⁵	
懇	恳	kʰəŋ³⁵	
啃	啃	kʰəŋ³⁵	
墾	垦	kʰəŋ⁴⁴	
詪	詪	ɡəŋ¹³	詪老頭
很	很	həŋ³⁵	
狠	狠	həŋ³⁵	
恆	恒	ɦəŋ²²¹	
恒	恒	ɦəŋ²²¹	
衡	衡	ɦəŋ²²¹	
痕	痕	ɦəŋ²²¹	
莖	茎	ɦəŋ²²¹	
恨	恨	ɦəŋ¹³	
恩	恩	əŋ⁵³	
冰	冰	piŋ⁵³	
兵	兵	piŋ⁵³	
彬	彬	piŋ⁵³	
賓	宾	piŋ⁵³	
擯	摈	piŋ⁵³	擯棄
濱	滨	piŋ⁵³	
斌	斌	piŋ⁵³	
繽	缤	piŋ⁵³	
丙	丙	piŋ³⁵	
餅	饼	piŋ³⁵	
炳	炳	piŋ³⁵	
秉	秉	piŋ³⁵	
稟	禀	piŋ³⁵	
柄	柄	piŋ³⁵	話柄
併	并	piŋ³⁵	合併
并	并	piŋ³⁵	合并
殯	殡	piŋ⁴⁴	
鬢	鬓	piŋ⁴⁴	
柄	柄	piŋ⁴⁴	把柄
拼	拼	pʰiŋ⁵³	
姘	姘	pʰiŋ⁵³	
品	品	pʰiŋ³⁵	
聘	聘	pʰiŋ⁴⁴	
平	平	biŋ²²¹	
憑	凭	biŋ²²¹	
坪	坪	biŋ²²¹	
評	评	biŋ²²¹	
屏	屏	biŋ²²¹	
萍	萍	biŋ²²¹	
蘋	苹	biŋ²²¹	
頻	频	biŋ²²¹	
貧	贫	biŋ²²¹	
病	病	biŋ¹³	
瓶	瓶	biŋ¹³	
並	并	biŋ¹³	並且
萌	萌	miŋ²²¹	
鳴	鸣	miŋ²²¹	
名	名	miŋ²²¹	
民	民	miŋ²²¹	
明	明	miŋ²²¹	文讀
閩	闽	miŋ¹³	
憫	悯	miŋ¹³	
敏	敏	miŋ¹³	
命	命	miŋ¹³	
盟	盟	miŋ¹³	
銘	铭	miŋ¹³	
皿	皿	miŋ¹³	
冥	冥	miŋ¹³	
螟	螟	miŋ¹³	
瞑	瞑	miŋ¹³	
酩	酩	miŋ¹³	
抿	抿	miŋ¹³	
丁	丁	tiŋ⁵³	
鼎	鼎	tiŋ³⁵	
頂	顶	tiŋ³⁵	文讀
訂	订	tiŋ⁴⁴	
釘	钉	tiŋ⁴⁴	
盯	盯	tiŋ⁴⁴	
叮	叮	tiŋ⁴⁴	
疔	疔	tiŋ⁴⁴	
聽	听	tʰiŋ⁵³	
汀	汀	tʰiŋ⁵³	
廳	厅	tʰiŋ⁵³	
艇	艇	tʰiŋ⁵³	
挺	挺	tʰiŋ³⁵	
廷	廷	diŋ²²¹	
庭	庭	diŋ²²¹	
蜓	蜓	diŋ²²¹	
錠	锭	diŋ²²¹	
亭	亭	diŋ²²¹	
停	停	diŋ¹³	
定	定	diŋ¹³	
陵	陵	liŋ²²¹	
凌	凌	liŋ²²¹	
靈	灵	liŋ²²¹	
零	零	liŋ²²¹	
鈴	铃	liŋ²²¹	
伶	伶	liŋ²²¹	
翎	翎	liŋ²²¹	
另	另	liŋ²²¹	
林	林	liŋ²²¹	
淋	淋	liŋ²²¹	
臨	临	liŋ²²¹	
鄰	邻	liŋ²²¹	
鱗	鳞	liŋ²²¹	
磷	磷	liŋ²²¹	
霖	霖	liŋ²²¹	
琳	琳	liŋ²²¹	
凜	凛	liŋ²²¹	
玲	玲	liŋ²²¹	
齡	龄	liŋ²²¹	
羚	羚	liŋ²²¹	
躪	躏	liŋ²²¹	
菱	菱	liŋ²²¹	文讀
領	领	liŋ¹³	
檁	檩	liŋ¹³	
令	令	liŋ¹³	
嶺	岭	liŋ¹³	
吝	吝	liŋ¹³	
徵	征	tɕiŋ⁵³	
征	征	tɕiŋ⁵³	
京	京	tɕiŋ⁵³	
蒸	蒸	tɕiŋ⁵³	
荊	荆	tɕiŋ⁵³	
精	精	tɕiŋ⁵³	
晶	晶	tɕiŋ⁵³	
睛	睛	tɕiŋ⁵³	
境	境	tɕiŋ⁵³	
景	景	tɕiŋ⁵³	
症	症	tɕiŋ⁵³	
針	针	tɕiŋ⁵³	
斟	斟	tɕiŋ⁵³	
今	今	tɕiŋ⁵³	
金	金	tɕiŋ⁵³	
津	津	tɕiŋ⁵³	
進	进	tɕiŋ⁵³	
筋	筋	tɕiŋ⁵³	
巾	巾	tɕiŋ⁵³	
襟	襟	tɕiŋ⁵³	
砧	砧	tɕiŋ⁵³	
貞	贞	tɕiŋ⁵³	
晉	晋	tɕiŋ⁵³	
偵	侦	tɕiŋ⁵³	
幀	帧	tɕiŋ⁵³	
腈	腈	tɕiŋ⁵³	腈肉
正	正	tɕiŋ⁵³	正月
禁	禁	tɕiŋ⁵³	不禁
警	警	tɕiŋ³⁵	
整	整	tɕiŋ³⁵	
頸	颈	tɕiŋ³⁵	
錦	锦	tɕiŋ³⁵	
謹	谨	tɕiŋ³⁵	
井	井	tɕiŋ³⁵	
枕	枕	tɕiŋ³⁵	
緊	紧	tɕiŋ³⁵	
斤	斤	tɕiŋ³⁵	
經	经	tɕiŋ⁴⁴	
證	证	tɕiŋ⁴⁴	
敬	敬	tɕiŋ⁴⁴	
竟	竟	tɕiŋ⁴⁴	
鏡	镜	tɕiŋ⁴⁴	
政	政	tɕiŋ⁴⁴	
徑	径	tɕiŋ⁴⁴	
浸	浸	tɕiŋ⁴⁴	
進	进	tɕiŋ⁴⁴	
怔	怔	tɕiŋ⁴⁴	
勁	劲	tɕiŋ⁴⁴	勁敵
正	正	tɕiŋ⁴⁴	公正
禁	禁	tɕiŋ⁴⁴	禁止
清	清	tɕʰiŋ⁵³	
青	青	tɕʰiŋ⁵³	
輕	轻	tɕʰiŋ⁵³	
傾	倾	tɕʰiŋ⁵³	
蜻	蜻	tɕʰiŋ⁵³	
侵	侵	tɕʰiŋ⁵³	
親	亲	tɕʰiŋ⁵³	親切
請	请	tɕʰiŋ³⁵	
趁	趁	tɕʰiŋ⁴⁴	
秤	秤	tɕʰiŋ⁴⁴	
稱	称	tɕʰiŋ⁴⁴	
櫬	榇	tɕʰiŋ⁴⁴	
逞	逞	tɕʰiŋ⁴⁴	
蟶	蛏	tɕʰiŋ⁴⁴	
欽	钦	tɕʰiŋ⁴⁴	
寢	寝	tɕʰiŋ⁴⁴	
沁	沁	tɕʰiŋ⁴⁴	
衾	衾	tɕʰiŋ⁴⁴	
撳	揿	tɕʰiŋ⁴⁴	
卿	卿	tɕʰiŋ⁴⁴	
頃	顷	tɕʰiŋ⁴⁴	
磬	磬	tɕʰiŋ⁴⁴	
罄	罄	tɕʰiŋ⁴⁴	
慶	庆	tɕʰiŋ⁴⁴	
親	亲	tɕʰiŋ⁴⁴	親家
近	近	dʑiŋ²²¹	
僅	仅	dʑiŋ²²¹	
矜	矜	dʑiŋ²²¹	
瑾	瑾	dʑiŋ²²¹	
堇	堇	dʑiŋ²²¹	
饉	馑	dʑiŋ²²¹	
巹	卺	dʑiŋ²²¹	
覲	觐	dʑiŋ²²¹	
鯨	鲸	dʑiŋ²²¹	
儆	儆	dʑiŋ²²¹	
陣	阵	dʑiŋ²²¹	
朕	朕	dʑiŋ²²¹	
鴆	鸩	dʑiŋ²²¹	
拯	拯	dʑiŋ²²¹	
沉	沉	dʑiŋ²²¹	
塵	尘	dʑiŋ²²¹	
臣	臣	dʑiŋ²²¹	
忱	忱	dʑiŋ²²¹	
橙	橙	dʑiŋ²²¹	
城	城	dʑiŋ²²¹	
承	承	dʑiŋ²²¹	
乘	乘	dʑiŋ²²¹	
呈	呈	dʑiŋ²²¹	
誠	诚	dʑiŋ²²¹	
懲	惩	dʑiŋ²²¹	
澄	澄	dʑiŋ²²¹	
埕	埕	dʑiŋ²²¹	
丞	丞	dʑiŋ²²¹	
琴	琴	dʑiŋ²²¹	
勤	勤	dʑiŋ²²¹	
禽	禽	dʑiŋ²²¹	
擒	擒	dʑiŋ²²¹	
芹	芹	dʑiŋ²²¹	
檎	檎	dʑiŋ²²¹	
噙	噙	dʑiŋ²²¹	
情	情	dʑiŋ²²¹	
擎	擎	dʑiŋ²²¹	
黥	黥	dʑiŋ²²¹	
仍	仍	dʑiŋ²²¹	
靳	靳	dʑiŋ²²¹	
鄭	郑	dʑiŋ²²¹	
陳	陈	dʑiŋ²²¹	
成	成	dʑiŋ²²¹	
程	程	dʑiŋ²²¹	
秦	秦	dʑiŋ²²¹	
岑	岑	dʑiŋ²²¹	姓
盡	尽	dʑiŋ³⁵	
靖	靖	dʑiŋ³⁵	
剩	剩	dʑiŋ³⁵	
競	竞	dʑiŋ³⁵	
勁	劲	dʑiŋ³⁵	勁道
凝	凝	ȵiŋ²²¹	
擰	拧	ȵiŋ²²¹	
檸	柠	ȵiŋ²²¹	
濘	泞	ȵiŋ²²¹	
獰	狞	ȵiŋ²²¹	
銀	银	ȵiŋ²²¹	
吟	吟	ȵiŋ²²¹	
垠	垠	ȵiŋ²²¹	
鄞	鄞	ȵiŋ²²¹	
齦	龈	ȵiŋ²²¹	
狺	狺	ȵiŋ²²¹	
迎	迎	ȵiŋ²²¹	
壬	壬	ȵiŋ²²¹	
賃	赁	ȵiŋ²²¹	
人	人	ȵiŋ²²¹	白讀
仁	仁	ȵiŋ²²¹	白讀
寧	宁	ȵiŋ²²¹	文讀
佞	佞	ȵiŋ¹³	
認	认	ȵiŋ¹³	白讀
刃	刃	ȵiŋ¹³	白讀
任	任	ȵiŋ¹³	白讀
忍	忍	ȵiŋ¹³	白讀
韌	韧	ȵiŋ¹³	白讀
新	新	ɕiŋ⁵³	
心	心	ɕiŋ⁵³	
辛	辛	ɕiŋ⁵³	
芯	芯	ɕiŋ⁵³	
欣	欣	ɕiŋ⁵³	
鋅	锌	ɕiŋ⁵³	
薪	薪	ɕiŋ⁵³	
馨	馨	ɕiŋ⁵³	
鑫	鑫	ɕiŋ⁵³	
星	星	ɕiŋ⁵³	
腥	腥	ɕiŋ⁵³	
惺	惺	ɕiŋ⁵³	
猩	猩	ɕiŋ⁵³	
深	深	ɕiŋ⁵³	
嬸	婶	ɕiŋ⁵³	
娠	娠	ɕiŋ⁵³	
莘	莘	ɕiŋ⁵³	
升	升	ɕiŋ⁵³	
聲	声	ɕiŋ⁵³	文讀
興	兴	ɕiŋ⁵³	興旺
審	审	ɕiŋ³⁵	
醒	醒	ɕiŋ³⁵	
沈	沈	ɕiŋ³⁵	
擤	擤	ɕiŋ³⁵	擤鼻涕
省	省	ɕiŋ³⁵	反省
勝	胜	ɕiŋ⁴⁴	
性	性	ɕiŋ⁴⁴	
姓	姓	ɕiŋ⁴⁴	
聖	圣	ɕiŋ⁴⁴	
迅	迅	ɕiŋ⁴⁴	
訊	讯	ɕiŋ⁴⁴	
汛	汛	ɕiŋ⁴⁴	
信	信	ɕiŋ⁴⁴	
釁	衅	ɕiŋ⁴⁴	
興	兴	ɕiŋ⁴⁴	興起
尋	寻	ʑiŋ²²¹	
晴	晴	ʑiŋ²²¹	
繩	绳	ʑiŋ²²¹	
盛	盛	ʑiŋ²²¹	茂盛
靜	静	ʑiŋ¹³	
淨	净	ʑiŋ¹³	
盈	盈	ʑiŋ¹³	
楹	楹	ʑiŋ¹³	
營	营	ɦiŋ²²¹	
瑩	莹	ɦiŋ²²¹	
螢	萤	ɦiŋ²²¹	
寅	寅	ɦiŋ²²¹	
淫	淫	ɦiŋ²²¹	
形	形	ɦiŋ²²¹	
刑	刑	ɦiŋ²²¹	
型	型	ɦiŋ²²¹	
幸	幸	ɦiŋ²²¹	
邢	邢	ɦiŋ²²¹	
霪	霪	ɦiŋ²²¹	
蚓	蚓	ɦiŋ²²¹	
夤	夤	ɦiŋ²²¹	
塋	茔	ɦiŋ²²¹	
贏	赢	ɦiŋ²²¹	
嬴	嬴	ɦiŋ²²¹	
瀠	潆	ɦiŋ²²¹	
瀛	瀛	ɦiŋ²²¹	
塍	塍	ɦiŋ²²¹	田塍
行	行	ɦiŋ²²¹	文讀 品行
引	引	ɦiŋ¹³	
孕	孕	ɦiŋ¹³	
英	英	iŋ⁵³	
因	因	iŋ⁵³	
音	音	iŋ⁵³	
陰	阴	iŋ⁵³	
姻	姻	iŋ⁵³	
穎	颖	iŋ⁵³	
嬰	婴	iŋ⁵³	
鷹	鹰	iŋ⁵³	
蠅	蝇	iŋ⁵³	
纓	缨	iŋ⁵³	
鶯	莺	iŋ⁵³	
罌	罂	iŋ⁵³	
膺	膺	iŋ⁵³	
櫻	樱	iŋ⁵³	文讀
鸚	鹦	iŋ⁵³	文讀
影	影	iŋ³⁵	
隱	隐	iŋ³⁵	
癮	瘾	iŋ³⁵	
印	印	iŋ⁴⁴	
熨	熨	iŋ⁴⁴	
飲	饮	iŋ⁴⁴	
殷	殷	iŋ⁴⁴	
蔭	荫	iŋ⁴⁴	
茵	茵	iŋ⁴⁴	
湮	湮	iŋ⁴⁴	
應	应	iŋ⁴⁴	
𢷍	𢷍	iŋ⁴⁴	量米
滾	滚	kuəŋ³⁵	
棍	棍	kuəŋ⁴⁴	
昆	昆	kʰuəŋ⁵³	
坤	坤	kʰuəŋ⁵³	
捆	捆	kʰuəŋ³⁵	
困	困	kʰuəŋ⁴⁴	
潰	溃	ɡuəŋ²²¹	潰膿
葷	荤	huəŋ⁵³	
昏	昏	huəŋ⁵³	
婚	婚	huəŋ⁵³	
餛	馄	ɦuəŋ²²¹	
渾	浑	ɦuəŋ²²¹	
魂	魂	ɦuəŋ²²¹	文讀
混	混	ɦuəŋ²²¹	混水
混	混	ɦuəŋ¹³	混合
溫	温	uəŋ⁵³	
温	温	uəŋ⁵³	
瘟	瘟	uəŋ⁵³	
搵	揾	uəŋ⁵³	搵醬油
揾	揾	uəŋ⁵³	揾醬油
穩	稳	uəŋ³⁵	
均	均	tɕyŋ⁵³	
鈞	钧	tɕyŋ⁵³	
君	君	tɕyŋ⁵³	
軍	军	tɕyŋ⁵³	
炯	炯	tɕyŋ⁵³	
窘	窘	tɕʰyŋ⁵³	
菌	菌	tɕʰyŋ⁵³	
羣	群	dʑyŋ²²¹	
裙	裙	dʑyŋ²²¹	
瓊	琼	dʑyŋ²²¹	
郡	郡	dʑyŋ¹³	
𡢿	𡢿	ȵyŋ²²¹	老𡢿 妻
勳	勋	ɕyŋ⁵³	
薰	熏	ɕyŋ⁵³	
燻	薰	ɕyŋ⁵³	
馴	驯	ɕyŋ⁵³	
訓	训	ɕyŋ⁴⁴	
勻	匀	ɦyŋ²²¹	
韻	韵	ɦyŋ²²¹	
蘊	蕴	yŋ⁵³	
蕴	蕴	yŋ⁵³	
真	真	tʃøŋ⁵³	
鎮	镇	tʃøŋ⁵³	
珍	珍	tʃøŋ⁵³	
診	诊	tʃøŋ⁵³	
疹	疹	tʃøŋ⁵³	
肫	肫	tʃøŋ⁵³	
峻	峻	tʃøŋ⁵³	
俊	俊	tʃøŋ⁵³	
駿	骏	tʃøŋ⁵³	
竣	竣	tʃøŋ⁵³	
準	准	tʃøŋ³⁵	
鎮	镇	tʃøŋ⁴⁴	
振	振	tʃøŋ⁴⁴	
震	震	tʃøŋ⁴⁴	
晉	晋	tʃøŋ⁴⁴	
春	春	tʃʰøŋ⁵³	
椿	椿	tʃʰøŋ⁵³	
蠢	蠢	tʃʰøŋ⁵³	
皴	皴	tʃʰøŋ⁴⁴	
身	身	ʃøŋ⁵³	
申	申	ʃøŋ⁵³	
伸	伸	ʃøŋ⁵³	
旬	旬	ʃøŋ⁵³	
詢	询	ʃøŋ⁵³	
荀	荀	ʃøŋ⁵³	
紳	绅	ʃøŋ⁵³	
呻	呻	ʃøŋ⁵³	
筍	笋	ʃøŋ³⁵	
榫	榫	ʃøŋ³⁵	
殉	殉	ʃøŋ⁴⁴	
舜	舜	ʃøŋ⁴⁴	
瞬	瞬	ʃøŋ⁴⁴	
浚	浚	ʃøŋ⁴⁴	
腎	肾	ʒøŋ²²¹	
循	循	ʒøŋ²²¹	
巡	巡	ʒøŋ²²¹	
脣	唇	ʒøŋ²²¹	
晨	晨	ʒøŋ²²¹	
辰	辰	ʒøŋ²²¹	
純	纯	ʒøŋ²²¹	
蓴	莼	ʒøŋ²²¹	
神	神	ʒøŋ²²¹	
慎	慎	ʒøŋ²²¹	
淳	淳	ʒøŋ²²¹	
諄	谆	ʒøŋ²²¹	
紉	纫	ʒøŋ²²¹	
仞	仞	ʒøŋ²²¹	
荏	荏	ʒøŋ²²¹	
飪	饪	ʒøŋ²²¹	
人	人	ʒøŋ²²¹	文讀
仁	仁	ʒøŋ²²¹	文讀
甚	甚	ʒøŋ¹³	
醇	醇	ʒøŋ¹³	
稔	稔	ʒøŋ¹³	稔熟
順	顺	ʒøŋ¹³	
潤	润	ʒøŋ¹³	
認	认	ʒøŋ¹³	文讀
忍	忍	ʒøŋ¹³	文讀
刃	刃	ʒøŋ¹³	文讀
韌	韧	ʒøŋ¹³	文讀
任	任	ʒøŋ¹³	文讀
賃	赁	ʒøŋ¹³	
崩	崩	poŋ⁵³	
蹦	蹦	poŋ⁵³	
捧	捧	pʰoŋ³⁵	
碰	碰	pʰoŋ⁴⁴	
蓬	蓬	boŋ²²¹	
篷	篷	boŋ²²¹	
袱	袱	boŋ²²¹	兒化變讀 戴頭袱
蒙	蒙	ʔmoŋ⁵³	
檬	檬	ʔmoŋ⁵³	
朦	朦	ʔmoŋ⁵³	
蠓	蠓	ʔmoŋ⁵³	
風	风	foŋ⁵³	
楓	枫	foŋ⁵³	
瘋	疯	foŋ⁵³	
豐	丰	foŋ⁵³	
丰	丰	foŋ⁵³	
封	封	foŋ⁵³	
峯	峰	foŋ⁵³	
鋒	锋	foŋ⁵³	
蜂	蜂	foŋ⁵³	
烽	烽	foŋ⁵³	
諷	讽	foŋ⁴⁴	
俸	俸	foŋ⁴⁴	
逢	逢	voŋ²²¹	
縫	缝	voŋ²²¹	縫衣
奉	奉	voŋ¹³	
鳳	凤	voŋ¹³	
馮	冯	voŋ¹³	
縫	缝	voŋ¹³	裂縫
東	东	toŋ⁵³	
冬	冬	toŋ⁵³	
懂	懂	toŋ³⁵	
董	董	toŋ³⁵	
凍	冻	toŋ⁴⁴	
棟	栋	toŋ⁴⁴	
通	通	tʰoŋ⁵³	
捅	捅	tʰoŋ³⁵	
統	统	tʰoŋ³⁵	
痛	痛	tʰoŋ⁴⁴	
同	同	doŋ²²¹	
銅	铜	doŋ²²¹	
桐	桐	doŋ²²¹	
筒	筒	doŋ²²¹	
童	童	doŋ²²¹	
彤	彤	doŋ²²¹	
瞳	瞳	doŋ²²¹	
桶	桶	doŋ¹³	
動	动	doŋ¹³	
洞	洞	doŋ¹³	
恫	恫	doŋ¹³	
農	农	noŋ²²¹	
膿	脓	noŋ²²¹	
齈	齈	noŋ⁴⁴	齈鼻頭
龍	龙	loŋ²²¹	
隆	隆	loŋ²²¹	
聾	聋	loŋ²²¹	
礱	砻	loŋ²²¹	
朧	胧	loŋ²²¹	
籠	笼	loŋ²²¹	鳥籠
路	路	loŋ²²¹	兒化變讀 引路幡
六	六	loŋ²²¹	兒化變讀 十五六
攏	拢	loŋ¹³	
隴	陇	loŋ¹³	
壟	垄	loŋ¹³	
弄	弄	loŋ¹³	
籠	笼	loŋ¹³	籠絡
鬃	鬃	tʃoŋ⁵³	
宗	宗	tʃoŋ⁵³	
蹤	踪	tʃoŋ⁵³	
棕	棕	tʃoŋ⁵³	
忠	忠	tʃoŋ⁵³	
鐘	钟	tʃoŋ⁵³	
衷	衷	tʃoŋ⁵³	
盅	盅	tʃoŋ⁵³	
鍾	锺	tʃoŋ⁵³	
冢	冢	tʃoŋ⁵³	
中	中	tʃoŋ⁵³	中心
總	总	tʃoŋ³⁵	
腫	肿	tʃoŋ³⁵	
種	种	tʃoŋ³⁵	種子
終	终	tʃoŋ⁴⁴	
縱	纵	tʃoŋ⁴⁴	
綜	综	tʃoŋ⁴⁴	
糉	粽	tʃoŋ⁴⁴	
粽	粽	tʃoŋ⁴⁴	
衆	众	tʃoŋ⁴⁴	
眾	众	tʃoŋ⁴⁴	
種	种	tʃoŋ⁴⁴	種田
中	中	tʃoŋ⁴⁴	射中
聰	聪	tʃʰoŋ⁵³	
匆	匆	tʃʰoŋ⁵³	
蔥	葱	tʃʰoŋ⁵³	
囪	囱	tʃʰoŋ⁵³	
充	充	tʃʰoŋ⁵³	
衝	冲	tʃʰoŋ⁵³	
慫	怂	tʃʰoŋ⁵³	
寵	宠	tʃʰoŋ⁵³	
銃	铳	tʃʰoŋ⁴⁴	
叢	丛	dʒoŋ²²¹	
從	从	dʒoŋ²²¹	
蟲	虫	dʒoŋ²²¹	
崇	崇	dʒoŋ²²¹	
茸	茸	dʒoŋ²²¹	
重	重	dʒoŋ²²¹	重復
訟	讼	dʒoŋ¹³	
仲	仲	dʒoŋ¹³	
誦	诵	dʒoŋ¹³	
頌	颂	dʒoŋ¹³	
重	重	dʒoŋ¹³	重要
鬆	松	ʃoŋ⁵³	
松	松	ʃoŋ⁵³	
嵩	嵩	ʃoŋ⁵³	
叔	叔	ʃoŋ⁵³	兒化變讀 阿叔
聳	耸	ʃoŋ³⁵	
送	送	ʃoŋ⁴⁴	
宋	宋	ʃoŋ⁴⁴	
公	公	koŋ⁵³	
蚣	蚣	koŋ⁵³	
工	工	koŋ⁵³	
功	功	koŋ⁵³	
攻	攻	koŋ⁵³	
弓	弓	koŋ⁵³	
躬	躬	koŋ⁵³	
宮	宫	koŋ⁵³	
恭	恭	koŋ⁵³	
汞	汞	koŋ⁵³	
龔	龚	koŋ⁵³	
鞏	巩	koŋ³⁵	
拱	拱	koŋ³⁵	
供	供	koŋ⁴⁴	
貢	贡	koŋ⁴⁴	
空	空	kʰoŋ⁵³	空虛
孔	孔	kʰoŋ³⁵	
恐	恐	kʰoŋ³⁵	
控	控	kʰoŋ⁴⁴	
空	空	kʰoŋ⁴⁴	空缺
共	共	ɡoŋ³⁵	
哄	哄	hoŋ³⁵	哄騙
轟	轰	hoŋ⁴⁴	
烘	烘	hoŋ⁴⁴	
哄	哄	hoŋ⁴⁴	起哄
弘	弘	ɦoŋ²²¹	
宏	宏	ɦoŋ²²¹	
紅	红	ɦoŋ²²¹	
洪	洪	ɦoŋ²²¹	
鴻	鸿	ɦoŋ²²¹	
虹	虹	ɦoŋ²²¹	
鑊	镬	ɦoŋ²²¹	兒化變讀 尺四鑊
翁	翁	oŋ⁵³	
屋	屋	oŋ⁵³	兒化變讀 東新屋
甕	瓮	oŋ³⁵	
均	均	tɕyoŋ⁵³	yn韻字又讀yon韻
鈞	钧	tɕyoŋ⁵³	yn韻字又讀yon韻
君	君	tɕyoŋ⁵³	yn韻字又讀yon韻
軍	军	tɕyoŋ⁵³	yn韻字又讀yon韻
炯	炯	tɕyoŋ⁵³	yn韻字又讀yon韻
窘	窘	tɕʰyoŋ⁵³	yn韻字又讀yon韻
菌	菌	tɕʰyoŋ⁵³	yn韻字又讀yon韻
窮	穷	dʑyoŋ²²¹	
羣	群	dʑyoŋ²²¹	yn韻字又讀yon韻
裙	裙	dʑyoŋ²²¹	yn韻字又讀yon韻
瓊	琼	dʑyoŋ²²¹	yn韻字又讀yon韻
郡	郡	dʑyoŋ¹³	yn韻字又讀yon韻
絨	绒	ȵyoŋ²²¹	
戎	戎	ȵyoŋ²²¹	
濃	浓	ȵyoŋ²²¹	
𡢿	𡢿	ȵyoŋ²²¹	老𡢿 妻 yn韻字又讀yon韻
兄	兄	ɕyoŋ⁵³	
胸	胸	ɕyoŋ⁵³	
兇	凶	ɕyoŋ⁵³	
匈	匈	ɕyoŋ⁵³	
洶	汹	ɕyoŋ⁵³	
勳	勋	ɕyoŋ⁵³	yn韻字又讀yon韻
薰	熏	ɕyoŋ⁵³	yn韻字又讀yon韻
燻	薰	ɕyoŋ⁵³	yn韻字又讀yon韻
馴	驯	ɕyoŋ⁵³	yn韻字又讀yon韻
嗅	嗅	ɕyoŋ⁴⁴	
訓	训	ɕyoŋ⁴⁴	yn韻字又讀yon韻
榮	荣	ɦyoŋ²²¹	
熒	荧	ɦyoŋ²²¹	
熊	熊	ɦyoŋ²²¹	
雄	雄	ɦyoŋ²²¹	
融	融	ɦyoŋ²²¹	
容	容	ɦyoŋ²²¹	
溶	溶	ɦyoŋ²²¹	
蓉	蓉	ɦyoŋ²²¹	
熔	熔	ɦyoŋ²²¹	
庸	庸	ɦyoŋ²²¹	
雲	云	ɦyoŋ²²¹	
云	云	ɦyoŋ²²¹	
螢	萤	ɦyoŋ²²¹	
勻	匀	ɦyoŋ²²¹	yn韻字又讀yon韻
韻	韵	ɦyoŋ²²¹	yn韻字又讀yon韻
允	允	ɦyoŋ¹³	
用	用	ɦyoŋ¹³	
運	运	ɦyoŋ¹³	
暈	晕	ɦyoŋ¹³	
尹	尹	ɦyoŋ¹³	
閏	闰	ɦyoŋ¹³	
傭	佣	ɦyoŋ¹³	
壅	壅	yoŋ⁵³	壅泥
蘊	蕴	yoŋ⁵³	yn韻字又讀yon韻
蕴	蕴	yoŋ⁵³	yn韻字又讀yon韻
永	永	yoŋ³⁵	
雍	雍	yoŋ³⁵	
擁	拥	yoŋ³⁵	
甬	甬	yoŋ³⁵	
勇	勇	yoŋ³⁵	
涌	涌	yoŋ³⁵	
泳	泳	yoŋ³⁵	
詠	咏	yoŋ³⁵	
踊	踊	yoŋ³⁵	
蛹	蛹	yoŋ³⁵	
恿	恿	yoŋ³⁵	
臃	臃	yoŋ³⁵	
百	百	paʔ⁵	
柏	柏	paʔ⁵	
伯	伯	paʔ⁵	
八	八	paʔ⁵	
鉢	钵	paʔ⁵	
撥	拨	paʔ⁵	
不	不	paʔ⁵	
迫	迫	paʔ⁵	
爸	爸	paʔ⁵	阿爸
拍	拍	pʰaʔ⁵	
魄	魄	pʰaʔ⁵	氣魄
潑	泼	pʰaʔ⁵	
粕	粕	pʰaʔ⁵	
白	白	baʔ²	
帛	帛	baʔ²	
拔	拔	baʔ²	
鈸	钹	baʔ²	
跋	跋	baʔ²	
勃	勃	baʔ²	
孛	孛	baʔ²	
渤	渤	baʔ²	
鵓	鹁	baʔ²	
鼻	鼻	baʔ²	白讀 鼻頭管
陌	陌	maʔ²	
麥	麦	maʔ²	
脈	脉	maʔ²	
抹	抹	maʔ²	
沫	沫	maʔ²	
襪	袜	maʔ²	
沒	没	maʔ²	
末	末	maʔ²	
默	默	maʔ²	
茉	茉	maʔ²	
歿	殁	maʔ²	
沒	没	maʔ²	嘸沒合音
法	法	faʔ⁵	
發	发	faʔ⁵	
髮	发	faʔ⁵	
弗	弗	faʔ⁵	
拂	拂	faʔ⁵	
勿	勿	faʔ⁵	
琺	珐	faʔ⁵	
砝	砝	faʔ⁵	
乏	乏	vaʔ²	
伐	伐	vaʔ²	
筏	筏	vaʔ²	
罰	罚	vaʔ²	
閥	阀	vaʔ²	
佛	佛	vaʔ²	
物	物	vaʔ²	
答	答	taʔ⁵	
搭	搭	taʔ⁵	
得	得	taʔ⁵	
德	德	taʔ⁵	
褡	褡	taʔ⁵	
瘩	瘩	taʔ⁵	
掇	掇	taʔ⁵	用手端
怛	怛	taʔ⁵	怛怛動
𡍲	𡍲	taʔ⁵	地名
塔	塔	tʰaʔ⁵	
榻	榻	tʰaʔ⁵	
塌	塌	tʰaʔ⁵	
獺	獭	tʰaʔ⁵	
脫	脱	tʰaʔ⁵	
脱	脱	tʰaʔ⁵	
禿	秃	tʰaʔ⁵	
拓	拓	tʰaʔ⁵	拓碑
忒	忒	tʰaʔ⁵	太
蹋	蹋	tʰaʔ⁵	糟蹋
遢	遢	tʰaʔ⁵	邋遢
踏	踏	daʔ²	
特	特	daʔ²	
達	达	daʔ²	
奪	夺	daʔ²	
突	突	daʔ²	
撻	挞	daʔ²	
凸	凸	daʔ²	
沓	沓	daʔ²	一沓紙
納	纳	naʔ²	
捺	捺	naʔ²	
衲	衲	naʔ²	尿衲
那	那	ʔnaʔ⁵	授物示意
臘	腊	laʔ²	
蠟	蜡	laʔ²	
邋	邋	laʔ²	
肋	肋	laʔ²	
勒	勒	laʔ²	
辣	辣	laʔ²	
垃	垃	laʔ²	
捋	捋	laʔ²	
獵	猎	laʔ²	
欄	栏	laʔ²	白讀 柵欄
攔	拦	laʔ²	白讀 攔牢
劣	劣	laʔ²	
嘞	嘞	ʔlaʔ⁵	嘞嘞響
則	则	tsaʔ⁵	
窄	窄	tsaʔ⁵	
責	责	tsaʔ⁵	
扎	扎	tsaʔ⁵	
札	札	tsaʔ⁵	
仄	仄	tsaʔ⁵	
卒	卒	tsaʔ⁵	
隻	只	tsaʔ⁵	隻身
摘	摘	tsaʔ⁵	
插	插	tsʰaʔ⁵	
拆	拆	tsʰaʔ⁵	
策	策	tsʰaʔ⁵	
冊	册	tsʰaʔ⁵	
擦	擦	tsʰaʔ⁵	
察	察	tsʰaʔ⁵	
撮	撮	tsʰaʔ⁵	
側	侧	tsʰaʔ⁵	
測	测	tsʰaʔ⁵	
㿭	㿭	tsʰaʔ⁵	皴㿭
漆	漆	tsʰaʔ⁵	白讀
赤	赤	tsʰaʔ⁵	白讀 赤豆
尺	尺	tsʰaʔ⁵	白讀
斥	斥	tsʰaʔ⁵	白讀 斥退
澤	泽	dzaʔ²	
擇	择	dzaʔ²	
宅	宅	dzaʔ²	
眨	眨	saʔ⁵	
塞	塞	saʔ⁵	
柵	栅	saʔ⁵	
澀	涩	saʔ⁵	
薩	萨	saʔ⁵	
殺	杀	saʔ⁵	
瑟	瑟	saʔ⁵	
蝨	虱	saʔ⁵	
圾	圾	saʔ⁵	
色	色	saʔ⁵	
剎	刹	saʔ⁵	
煞	煞	saʔ⁵	
霎	霎	saʔ⁵	
率	率	saʔ⁵	率領
撒	撒	saʔ⁵	撒手
雜	杂	zaʔ²	
閘	闸	zaʔ²	
賊	贼	zaʔ²	
擇	择	zaʔ²	家擇科
鍘	铡	zaʔ²	
碩	硕	zaʔ²	
煠	煠	zaʔ²	油煠檜
炸	炸	zaʔ²	油炸檜
石	石	zaʔ²	白讀
蛤	蛤	kaʔ⁵	
鴿	鸽	kaʔ⁵	
夾	夹	kaʔ⁵	
格	格	kaʔ⁵	
革	革	kaʔ⁵	
隔	隔	kaʔ⁵	
割	割	kaʔ⁵	
葛	葛	kaʔ⁵	
疙	疙	kaʔ⁵	
甲	甲	kaʔ⁵	白讀 盔甲
胛	胛	kaʔ⁵	白讀 肩胛
合	合	kaʔ⁵	合算
磕	磕	kʰaʔ⁵	
掐	掐	kʰaʔ⁵	
刻	刻	kʰaʔ⁵	
客	客	kʰaʔ⁵	
克	克	kʰaʔ⁵	
咳	咳	kʰaʔ⁵	
渴	渴	kʰaʔ⁵	
瞌	瞌	kʰaʔ⁵	
甲	甲	kʰaʔ⁵	白讀 指甲
軋	轧	ɡaʔ²	
額	额	ŋaʔ²	
𩓥	𫖵	ʔŋaʔ⁵	𩓥𩓥動
喝	喝	haʔ⁵	
黑	黑	haʔ⁵	
赫	赫	haʔ⁵	
嚇	吓	haʔ⁵	
瞎	瞎	haʔ⁵	
郝	郝	haʔ⁵	姓
盒	盒	ɦaʔ²	
狹	狭	ɦaʔ²	
匣	匣	ɦaʔ²	
轄	辖	ɦaʔ²	
核	核	ɦaʔ²	文讀 核能
合	合	ɦaʔ²	合作
壓	压	aʔ⁵	
押	押	aʔ⁵	
扼	扼	aʔ⁵	
鴨	鸭	aʔ⁵	
阿	阿	aʔ⁵	阿大
峽	峡	tɕiaʔ⁵	
甲	甲	tɕiaʔ⁵	文讀 甲乙丙丁
恰	恰	tɕʰiaʔ⁵	
揠	揠	iaʔ⁵	
括	括	kuaʔ⁵	
刮	刮	kuaʔ⁵	
骨	骨	kuaʔ⁵	
闊	阔	kʰuaʔ⁵	
窟	窟	kʰuaʔ⁵	
刮	刮	ɡuaʔ²	刮翼梢
忽	忽	huaʔ⁵	
豁	豁	huaʔ⁵	開豁
活	活	ɦuaʔ²	
滑	滑	ɦuaʔ²	
猾	猾	ɦuaʔ²	
杌	杌	ɦuaʔ²	席子
兀	兀	ɦuaʔ²	
囫	囫	ɦuaʔ²	囫圇吞
魂	魂	ɦuaʔ²	白讀 魂靈
核	核	ɦuaʔ²	白讀 果核
劃	划	ɦuaʔ²	計劃
還	还	ɦuaʔ²	白讀 還是
挖	挖	uaʔ⁵	
質	质	tʃøʔ⁵	
折	折	tʃøʔ⁵	
哲	哲	tʃøʔ⁵	
浙	浙	tʃøʔ⁵	
蜇	蜇	tʃøʔ⁵	
這	这	tʃøʔ⁵	
給	给	tʃøʔ⁵	交給
出	出	tʃʰøʔ⁵	
徹	彻	tʃʰøʔ⁵	
撤	撤	tʃʰøʔ⁵	
澈	澈	tʃʰøʔ⁵	
赤	赤	tʃʰøʔ⁵	白讀 赤裸
綽	绰	tʃʰøʔ⁵	白讀 闊綽
斥	斥	tʃʰøʔ⁵	白讀 斥退
雪	雪	ʃøʔ⁵	
說	说	ʃøʔ⁵	
失	失	ʃøʔ⁵	
室	室	ʃøʔ⁵	
戌	戌	ʃøʔ⁵	
刷	刷	ʃøʔ⁵	
集	集	ʒøʔ²	
十	十	ʒøʔ²	
什	什	ʒøʔ²	
入	入	ʒøʔ²	
實	实	ʒøʔ²	
術	术	ʒøʔ²	
述	述	ʒøʔ²	
拾	拾	ʒøʔ²	
若	若	ʒøʔ²	
日	日	ʒøʔ²	文讀
習	习	ʒøʔ²	
逼	逼	pieʔ⁵	
碧	碧	pieʔ⁵	
壁	壁	pieʔ⁵	
璧	璧	pieʔ⁵	
鱉	鳖	pieʔ⁵	
憋	憋	pieʔ⁵	
筆	笔	pieʔ⁵	
畢	毕	pieʔ⁵	
必	必	pieʔ⁵	
癟	瘪	pieʔ⁵	
瞥	瞥	pieʔ⁵	
僻	僻	pʰieʔ⁵	
闢	辟	pʰieʔ⁵	
劈	劈	pʰieʔ⁵	
撇	撇	pʰieʔ⁵	
匹	匹	pʰieʔ⁵	
霹	霹	pʰieʔ⁵	
癖	癖	pʰieʔ⁵	
別	别	bieʔ²	
蹩	蹩	bieʔ²	
愎	愎	bieʔ²	
弼	弼	bieʔ²	
鼻	鼻	bieʔ²	文讀
密	密	mieʔ²	
蜜	蜜	mieʔ²	
滅	灭	mieʔ²	
蔑	蔑	mieʔ²	
篾	篾	mieʔ²	
冪	幂	mieʔ²	
覓	觅	mieʔ²	
的	的	tieʔ⁵	
滴	滴	tieʔ⁵	
嫡	嫡	tieʔ⁵	
跌	跌	tieʔ⁵	
摘	摘	tieʔ⁵	
踢	踢	tʰieʔ⁵	
惕	惕	tʰieʔ⁵	
剔	剔	tʰieʔ⁵	
帖	帖	tʰieʔ⁵	
貼	贴	tʰieʔ⁵	
鐵	铁	tʰieʔ⁵	
笛	笛	dieʔ²	
敵	敌	dieʔ²	
糴	籴	dieʔ²	
疊	叠	dieʔ²	
牒	牒	dieʔ²	
蝶	蝶	dieʔ²	
諜	谍	dieʔ²	
碟	碟	dieʔ²	
滌	涤	dieʔ²	
迪	迪	dieʔ²	
狄	狄	dieʔ²	
迭	迭	dieʔ²	
略	略	lieʔ²	
掠	掠	lieʔ²	
力	力	lieʔ²	
歷	历	lieʔ²	
立	立	lieʔ²	
笠	笠	lieʔ²	
列	列	lieʔ²	
裂	裂	lieʔ²	
烈	烈	lieʔ²	
慄	栗	lieʔ²	
栗	栗	lieʔ²	
律	律	lieʔ²	
粒	粒	lieʔ²	
瀝	沥	lieʔ²	
率	率	lieʔ²	效率
劣	劣	lieʔ²	
爵	爵	tɕieʔ⁵	
酌	酌	tɕieʔ⁵	
即	即	tɕieʔ⁵	
腳	脚	tɕieʔ⁵	
脚	脚	tɕieʔ⁵	
織	织	tɕieʔ⁵	
職	职	tɕieʔ⁵	
積	积	tɕieʔ⁵	
跡	迹	tɕieʔ⁵	
脊	脊	tɕieʔ⁵	
績	绩	tɕieʔ⁵	
擊	击	tɕieʔ⁵	
激	激	tɕieʔ⁵	
接	接	tɕieʔ⁵	
秸	秸	tɕieʔ⁵	
摺	摺	tɕieʔ⁵	
褶	褶	tɕieʔ⁵	
劫	劫	tɕieʔ⁵	
執	执	tɕieʔ⁵	
汁	汁	tɕieʔ⁵	
急	急	tɕieʔ⁵	
級	级	tɕieʔ⁵	
揭	揭	tɕieʔ⁵	
節	节	tɕieʔ⁵	
結	结	tɕieʔ⁵	
潔	洁	tɕieʔ⁵	
吉	吉	tɕieʔ⁵	
騭	骘	tɕieʔ⁵	傷陰騭
莢	荚	tɕieʔ⁵	豆莢
戟	戟	tɕieʔ⁵	畫戟
着	着	tɕieʔ⁵	衣着
只	只	tɕieʔ⁵	白讀 只有
給	给	tɕieʔ⁵	供給
甲	甲	tɕieʔ⁵	文讀 甲乙丙丁
頰	颊	tɕieʔ⁵	面頰巴
鵲	鹊	tɕʰieʔ⁵	
雀	雀	tɕʰieʔ⁵	
卻	却	tɕʰieʔ⁵	
戚	戚	tɕʰieʔ⁵	
怯	怯	tɕʰieʔ⁵	
妾	妾	tɕʰieʔ⁵	
輯	辑	tɕʰieʔ⁵	
緝	缉	tɕʰieʔ⁵	
泣	泣	tɕʰieʔ⁵	
切	切	tɕʰieʔ⁵	
七	七	tɕʰieʔ⁵	
訖	讫	tɕʰieʔ⁵	
乞	乞	tɕʰieʔ⁵	
迄	迄	tɕʰieʔ⁵	
隙	隙	tɕʰieʔ⁵	
挈	挈	tɕʰieʔ⁵	挈匣
尺	尺	tɕʰieʔ⁵	白讀
綽	绰	tɕʰieʔ⁵	文讀 綽號
赤	赤	tɕʰieʔ⁵	文讀
漆	漆	tɕʰieʔ⁵	文讀
喫	吃	tɕʰieʔ⁵	文讀
斥	斥	tɕʰieʔ⁵	文讀
恰	恰	tɕʰieʔ⁵	
直	直	dʑieʔ²	
值	值	dʑieʔ²	
殖	殖	dʑieʔ²	
植	植	dʑieʔ²	
極	极	dʑieʔ²	
劇	剧	dʑieʔ²	
屐	屐	dʑieʔ²	
擲	掷	dʑieʔ²	
寂	寂	dʑieʔ²	
捷	捷	dʑieʔ²	
涉	涉	dʑieʔ²	
蟄	蛰	dʑieʔ²	
及	及	dʑieʔ²	
傑	杰	dʑieʔ²	
疾	疾	dʑieʔ²	
侄	侄	dʑieʔ²	
秩	秩	dʑieʔ²	
竭	竭	dʑieʔ²	
睫	睫	dʑieʔ²	
朮	术	dʑieʔ²	白朮
着	着	dʑieʔ²	火着
習	习	dʑieʔ²	
虐	虐	ȵieʔ²	
瘧	疟	ȵieʔ²	
逆	逆	ȵieʔ²	
聶	聂	ȵieʔ²	
鑷	镊	ȵieʔ²	
躡	蹑	ȵieʔ²	
業	业	ȵieʔ²	
熱	热	ȵieʔ²	
孽	孽	ȵieʔ²	
捏	捏	ȵieʔ²	
鎳	镍	ȵieʔ²	
匿	匿	ȵieʔ²	
箬	箬	ȵieʔ²	
溺	溺	ȵieʔ²	
日	日	ȵieʔ²	白讀
削	削	ɕieʔ⁵	
息	息	ɕieʔ⁵	
熄	熄	ɕieʔ⁵	
媳	媳	ɕieʔ⁵	
識	识	ɕieʔ⁵	
式	式	ɕieʔ⁵	
惜	惜	ɕieʔ⁵	
昔	昔	ɕieʔ⁵	
適	适	ɕieʔ⁵	
釋	释	ɕieʔ⁵	
錫	锡	ɕieʔ⁵	
析	析	ɕieʔ⁵	
攝	摄	ɕieʔ⁵	
脅	胁	ɕieʔ⁵	
溼	湿	ɕieʔ⁵	
吸	吸	ɕieʔ⁵	
薛	薛	ɕieʔ⁵	
歇	歇	ɕieʔ⁵	
蠍	蝎	ɕieʔ⁵	
屑	屑	ɕieʔ⁵	
悉	悉	ɕieʔ⁵	
膝	膝	ɕieʔ⁵	
飾	饰	ɕieʔ⁵	
晰	晰	ɕieʔ⁵	
淅	淅	ɕieʔ⁵	
嚼	嚼	ʑieʔ²	
弱	弱	ʑieʔ²	
食	食	ʑieʔ²	
舌	舌	ʑieʔ²	
蝕	蚀	ʑieʔ²	
藉	藉	ʑieʔ²	
席	席	ʑieʔ²	
蓆	席	ʑieʔ²	
夕	夕	ʑieʔ²	
射	射	ʑieʔ²	
籍	籍	ʑieʔ²	
汐	汐	ʑieʔ²	
襲	袭	ʑieʔ²	
石	石	ʑieʔ²	石花
截	截	ʑieʔ²	截斷
該	该	kieʔ⁵	這
藥	药	ɦieʔ²	
鑰	钥	ɦieʔ²	
躍	跃	ɦieʔ²	
翼	翼	ɦieʔ²	
亦	亦	ɦieʔ²	
譯	译	ɦieʔ²	
液	液	ɦieʔ²	
腋	腋	ɦieʔ²	
洽	洽	ɦieʔ²	
協	协	ɦieʔ²	
葉	叶	ɦieʔ²	
頁	页	ɦieʔ²	
逸	逸	ɦieʔ²	
易	易	ɦieʔ²	交易
峽	峡	ɦieʔ²	
乙	乙	ieʔ⁵	
約	约	ieʔ⁵	
抑	抑	ieʔ⁵	
益	益	ieʔ⁵	
揖	揖	ieʔ⁵	
壹	壹	ieʔ⁵	
噎	噎	ieʔ⁵	
一	一	ieʔ⁵	
溢	溢	ieʔ⁵	
邑	邑	ieʔ⁵	
億	亿	ieʔ⁵	
憶	忆	ieʔ⁵	
臆	臆	ieʔ⁵	
隘	隘	ieʔ⁵	狹隘
菊	菊	tɕyeʔ⁵	
拙	拙	tɕyeʔ⁵	
決	决	tɕyeʔ⁵	
訣	诀	tɕyeʔ⁵	
桔	桔	tɕyeʔ⁵	
抉	抉	tɕyeʔ⁵	
鞠	鞠	tɕyeʔ⁵	
覺	觉	tɕyeʔ⁵	文讀 覺悟
缺	缺	tɕʰyeʔ⁵	
曲	曲	tɕʰyeʔ⁵	
屈	屈	tɕʰyeʔ⁵	
確	确	tɕʰyeʔ⁵	
榷	榷	tɕʰyeʔ⁵	
畜	畜	tɕʰyeʔ⁵	畜牲
掘	掘	dʑyeʔ²	
倔	倔	dʑyeʔ²	
局	局	dʑyeʔ²	
軸	轴	dʑyeʔ²	
鐲	镯	dʑyeʔ²	
截	截	dʑyeʔ²	半截
血	血	ɕyeʔ⁵	
蓄	蓄	ɕyeʔ⁵	
旭	旭	ɕyeʔ⁵	
恤	恤	ɕyeʔ⁵	
畜	畜	ɕyeʔ⁵	畜牧
疫	疫	ɦyeʔ²	
役	役	ɦyeʔ²	
育	育	ɦyeʔ²	
悅	悦	ɦyeʔ²	
悦	悦	ɦyeʔ²	
閱	阅	ɦyeʔ²	
月	月	ɦyeʔ²	
越	越	ɦyeʔ²	
粵	粤	ɦyeʔ²	
穴	穴	ɦyeʔ²	
域	域	ɦyeʔ²	
浴	浴	ɦyeʔ²	文讀
欲	欲	ɦyeʔ²	
樂	乐	ɦyeʔ²	音樂
鬱	郁	yeʔ⁵	
博	博	poʔ⁵	
剝	剥	poʔ⁵	
卜	卜	poʔ⁵	
北	北	poʔ⁵	
搏	搏	poʔ⁵	
膊	膊	poʔ⁵	
駁	驳	poʔ⁵	
縛	缚	poʔ⁵	文讀
樸	朴	pʰoʔ⁵	
撲	扑	pʰoʔ⁵	
帕	帕	pʰoʔ⁵	
仆	仆	pʰoʔ⁵	前仆後繼
薄	薄	boʔ²	
雹	雹	boʔ²	
瀑	瀑	boʔ²	
泊	泊	boʔ²	
箔	箔	boʔ²	
舶	舶	boʔ²	
匐	匐	boʔ²	
礴	礴	boʔ²	
袱	袱	boʔ²	白讀
伏	伏	boʔ²	白讀
僕	仆	boʔ²	僕人
魄	魄	boʔ²	落魄
摸	摸	moʔ²	
墨	墨	moʔ²	
木	木	moʔ²	
目	目	moʔ²	
穆	穆	moʔ²	
牧	牧	moʔ²	
寞	寞	moʔ²	
漠	漠	moʔ²	
膜	膜	moʔ²	
睦	睦	moʔ²	
麼	么	moʔ²	
莫	莫	moʔ²	
福	福	foʔ⁵	
幅	幅	foʔ⁵	
腹	腹	foʔ⁵	
覆	覆	foʔ⁵	
輻	辐	foʔ⁵	
蝠	蝠	foʔ⁵	
複	复	foʔ⁵	重複
服	服	voʔ²	
伏	伏	voʔ²	文讀
復	复	voʔ²	復原
篤	笃	toʔ⁵	
督	督	toʔ⁵	
陡	陡	toʔ⁵	白讀
託	托	tʰoʔ⁵	
庹	庹	tʰoʔ⁵	一庹
拓	拓	tʰoʔ⁵	開拓
鐸	铎	doʔ²	
獨	独	doʔ²	
讀	读	doʔ²	
牘	牍	doʔ²	
毒	毒	doʔ²	
犢	犊	doʔ²	
踱	踱	doʔ²	
諾	诺	noʔ²	
喏	喏	noʔ²	
落	落	loʔ²	
烙	烙	loʔ²	
駱	骆	loʔ²	
洛	洛	loʔ²	
絡	络	loʔ²	
酪	酪	loʔ²	
鹿	鹿	loʔ²	
祿	禄	loʔ²	
六	六	loʔ²	
陸	陆	loʔ²	
綠	绿	loʔ²	
錄	录	loʔ²	
碌	碌	loʔ²	
戮	戮	loʔ²	殺戮
賂	赂	loʔ²	
麓	麓	loʔ²	
樂	乐	loʔ²	快樂
摝	摝	ʔloʔ⁵	摝鈴
作	作	tʃoʔ⁵	
桌	桌	tʃoʔ⁵	
卓	卓	tʃoʔ⁵	
琢	琢	tʃoʔ⁵	
啄	啄	tʃoʔ⁵	
竹	竹	tʃoʔ⁵	
築	筑	tʃoʔ⁵	
祝	祝	tʃoʔ⁵	
粥	粥	tʃoʔ⁵	
足	足	tʃoʔ⁵	
燭	烛	tʃoʔ⁵	
矚	瞩	tʃoʔ⁵	
捉	捉	tʃoʔ⁵	
囑	嘱	tʃoʔ⁵	
𠛢	𠛢	tʃoʔ⁵	𠛢柴
促	促	tʃʰoʔ⁵	
簇	簇	tʃʰoʔ⁵	
觸	触	tʃʰoʔ⁵	
戳	戳	tʃʰoʔ⁵	刺入
濁	浊	dʒoʔ²	
族	族	dʒoʔ²	
逐	逐	dʒoʔ²	
俗	俗	dʒoʔ²	
續	续	dʒoʔ²	
蜀	蜀	dʒoʔ²	
屬	属	dʒoʔ²	
絕	绝	dʒoʔ²	
昨	昨	dʒoʔ²	文讀 昨天
索	索	ʃoʔ⁵	
速	速	ʃoʔ⁵	
肅	肃	ʃoʔ⁵	
縮	缩	ʃoʔ⁵	
叔	叔	ʃoʔ⁵	文讀
粟	粟	ʃoʔ⁵	
束	束	ʃoʔ⁵	
朔	朔	ʃoʔ⁵	
宿	宿	ʃoʔ⁵	宿夜
鑿	凿	ʒoʔ²	
勺	勺	ʒoʔ²	
熟	熟	ʒoʔ²	
淑	淑	ʒoʔ²	
辱	辱	ʒoʔ²	
芍	芍	ʒoʔ²	
孰	孰	ʒoʔ²	
褥	褥	ʒoʔ²	
昨	昨	ʒoʔ²	白讀 昨日
各	各	koʔ⁵	
閣	阁	koʔ⁵	
郭	郭	koʔ⁵	
廓	廓	koʔ⁵	
角	角	koʔ⁵	
國	国	koʔ⁵	
谷	谷	koʔ⁵	
穀	谷	koʔ⁵	
覺	觉	koʔ⁵	白讀 覺渡
擱	搁	koʔ⁵	
擴	扩	kʰoʔ⁵	
殼	壳	kʰoʔ⁵	
哭	哭	kʰoʔ⁵	
酷	酷	kʰoʔ⁵	
擱	搁	ɡoʔ²	
鄂	鄂	ŋoʔ²	
鶴	鹤	ŋoʔ²	
嶽	岳	ŋoʔ²	
鱷	鳄	ŋoʔ²	
齶	腭	ŋoʔ²	
諤	谔	ŋoʔ²	
樂	乐	ŋoʔ²	姓
霍	霍	hoʔ⁵	
藿	藿	hoʔ⁵	
鑊	镬	ɦoʔ²	
學	学	ɦoʔ²	
或	或	ɦoʔ²	
惑	惑	ɦoʔ²	
獲	获	ɦoʔ²	
斛	斛	ɦoʔ²	
沃	沃	oʔ⁵	
握	握	oʔ⁵	
齷	龌	oʔ⁵	
惡	恶	oʔ⁵	惡劣
屋	屋	oʔ⁵	房屋
屋	屋	uoʔ⁵	屋裏 家裏
喫	吃	tɕʰyoʔ⁵	
肉	肉	ȵyoʔ²	
玉	玉	ȵyoʔ²	
揉	揉	ȵyoʔ²	
褥	褥	ȵyoʔ²	
浴	浴	ȵyoʔ²	白讀
欲	欲	ɦyoʔ²	
浴	浴	ɦyoʔ²	文讀
而	而	l̩²²¹	
爾	尔	l̩²²¹	
兒	儿	l̩²²¹	文讀
耳	耳	l̩¹³	文讀
二	二	l̩¹³	文讀
姆	姆	m̩²²¹	
畝	亩	m̩²²¹	白讀
拇	拇	m̩²²¹	
姆	姆	ʔm̩⁴⁴	姆姆
無	无	ʔm̩⁴⁴	白讀 無賬得算
芋	芋	ŋ̍¹³	芋艿
你	你	ŋ̍¹³	白讀
魚	鱼	ŋ̍²²¹	白讀
吳	吴	ŋ̍²²¹	白讀
五	五	ŋ̍²²¹	白讀
兒	儿	ŋ̍²²¹	白讀
孲	孲	ʔŋ̍⁴⁴	孲𤘅
㕶	㕶	ʔŋ̍⁴⁴	兒語屎
